Player,Team,Pos,Games,G,A,Pts,plusminus,SOG,PPG,PPA,PPP,Hits,BS,FP,FPGP
Aaron Ekblad,FLA,D,40,5,18,23,11,96,0,3,3,17,53,132.9,3.3225
Aaron Ness,ARI,D,18,0,1,1,1,9,0,0,0,16,13,20.6,1.144444444
Adam Boqvist,CHI,D,18,2,3,5,-6,25,0,2,2,10,15,33.5,1.861111111
Adam Brooks,TOR,C,3,0,1,1,1,1,0,0,0,0,1,3.4,1.133333333
Adam Erne,DET,LW,34,2,0,2,-17,45,0,0,0,97,18,73,2.147058824
Adam Fox,NYR,D,41,5,17,22,3,73,1,9,10,17,53,124.7,3.041463415
Adam Gaudette,VAN,C,32,8,10,18,-2,39,4,4,8,19,13,82.6,2.58125
Adam Henrique,ANH,C,42,14,10,24,2,100,2,2,4,40,15,134.5,3.202380952
Adam Johnson,PIT,C,7,1,1,2,-1,5,0,0,0,4,3,10,1.428571429
Adam Larsson,EDM,D,22,0,2,2,-11,25,0,0,0,34,44,47.5,2.159090909
Adam Lowry,WPG,LW,40,4,5,9,0,57,0,0,0,112,21,111.3,2.7825
Adam Pelech,NYI,D,38,1,8,9,4,49,0,0,0,81,83,122.6,3.226315789
Adrian Kempe,LA,C,42,8,9,17,-2,84,1,2,3,48,9,106.1,2.526190476
Alan Quine,CGY,C,9,1,0,1,-1,12,0,0,0,6,2,11.3,1.255555556
Alec Martinez,LA,D,25,0,5,5,-2,37,0,1,1,17,58,62.3,2.492
Aleksander Barkov,FLA,C,42,13,32,45,7,112,6,9,15,12,18,181.3,4.316666667
Aleksi Saarela,FLA,C,3,0,0,0,0,3,0,0,0,0,1,1.7,0.566666667
Alex Biega,DET,D,21,0,1,1,-2,16,0,0,0,47,18,39.9,1.9
Alex Chiasson,EDM,RW,38,4,8,12,-1,57,3,4,7,33,11,79.3,2.086842105
Alex DeBrincat,CHI,RW,43,10,20,30,-2,121,6,3,9,45,15,156.4,3.637209302
Alex Galchenyuk,PIT,RW,33,4,10,14,-3,58,2,3,5,28,9,77.2,2.339393939
Alex Goligoski,ARI,D,44,3,21,24,7,68,2,7,9,60,83,162.2,3.686363636
Alex Iafallo,LA,C,43,8,15,23,-4,85,4,2,6,32,26,121,2.813953488
Alex Kerfoot,TOR,C,38,7,10,17,3,57,1,2,3,32,26,97.3,2.560526316
Alex Killorn,TB,C,39,16,19,35,8,86,7,5,12,29,11,156.4,4.01025641
Alex Ovechkin,WAS,LW,43,24,16,40,-13,200,9,4,13,122,15,259,6.023255814
Alex Pietrangelo,STL,D,43,12,23,35,8,136,5,12,17,22,49,192.9,4.486046512
Alex Tuch,VGK,RW,28,6,7,13,-5,58,2,3,5,30,13,79.2,2.828571429
Alexander Edler,VAN,D,32,4,16,20,4,70,1,5,6,63,98,160.5,5.015625
Alexander Nylander,CHI,RW,39,5,9,14,-9,59,0,2,2,20,10,69.1,1.771794872
Alexander Radulov,DAL,RW,39,12,15,27,14,97,6,2,8,32,31,151.3,3.879487179
Alexander Steen,STL,LW,27,0,7,7,8,38,0,0,0,10,28,52.2,1.933333333
Alexander Volkov,TB,LW,4,0,0,0,-5,3,0,0,0,5,1,1.7,0.425
Alexander Wennberg,CLS,C,41,2,12,14,-5,54,1,4,5,12,24,72.1,1.758536585
Alexandre Carrier,NSH,D,1,0,0,0,1,1,0,0,0,1,0,1.4,1.4
Alexandre Texier,CLS,C,36,6,7,13,3,49,0,1,1,20,7,67.6,1.877777778
Anders Bjork,BOS,LW,35,6,5,11,0,48,1,0,1,27,13,68.2,1.948571429
Anders Lee,NYI,C,40,11,12,23,4,94,1,3,4,78,26,152.6,3.815
Andre Burakovsky,COL,LW,39,13,12,25,-2,75,1,7,8,13,24,118.5,3.038461538
Andreas Athanasiou,DET,C,36,5,14,19,-35,88,1,4,5,23,19,86.7,2.408333333
Andreas Englund,OTT,D,9,0,2,2,-3,4,0,0,0,23,6,18.6,2.066666667
Andreas Johnsson,TOR,LW,30,6,10,16,2,66,4,1,5,30,13,91.9,3.063333333
Andrei Svechnikov,CAR,RW,42,18,23,41,13,115,5,10,15,69,18,211,5.023809524
Andrej Sekera,DAL,D,38,2,5,7,9,40,0,0,0,25,58,78,2.052631579
Andrew Agozzino,PIT,LW,1,0,0,0,-1,0,0,0,0,1,0,0,0
Andrew Cogliano,DAL,LW,41,2,6,8,1,38,0,0,0,52,19,69.2,1.687804878
Andrew Copp,WPG,C,34,5,9,14,0,66,0,0,0,35,14,83.9,2.467647059
Andrew Ladd,NYI,LW,1,0,0,0,0,1,0,0,0,5,0,2.9,2.9
Andrew Mangiapane,CGY,LW,42,8,7,15,0,52,0,0,0,43,11,85.8,2.042857143
Andrew Peeke,CLS,D,7,0,1,1,3,3,0,0,0,12,9,15.2,2.171428571
Andrew Shaw,CHI,C,26,3,7,10,-4,46,1,1,2,74,9,82.9,3.188461538
Andy Andreoff,PHI,C,13,0,1,1,-2,13,0,0,0,20,4,18.2,1.4
Andy Greene,NJ,D,37,0,5,5,0,32,0,0,0,22,86,76.8,2.075675676
Anthony Beauvillier,NYI,LW,40,10,13,23,1,74,2,3,5,47,21,125.1,3.1275
Anthony Bitetto,WPG,D,32,0,4,4,2,41,0,0,0,92,31,86.9,2.715625
Anthony Cirelli,TB,C,40,9,18,27,10,68,1,2,3,49,27,136.2,3.405
Anthony DeAngelo,NYR,D,41,8,21,29,3,84,2,7,9,31,27,139.1,3.392682927
Anthony Duclair,OTT,LW,41,21,11,32,-2,123,5,2,7,38,25,171.7,4.187804878
Anthony Mantha,DET,RW,29,12,12,24,-9,95,4,2,6,34,18,125.5,4.327586207
Anthony Richard,NSH,C,1,0,0,0,-1,2,0,0,0,0,0,0.3,0.3
Antoine Roussel,VAN,LW,14,5,2,7,2,21,0,1,1,22,5,42.9,3.064285714
Anton Lindholm,COL,D,4,0,1,1,1,1,0,0,0,5,5,7.9,1.975
Anton Stralman,FLA,D,42,4,12,16,-7,55,0,0,0,42,62,106.5,2.535714286
Anton Wedin,CHI,LW,4,0,0,0,1,2,0,0,0,5,1,4.3,1.075
Antti Suomela,SJ,C,7,0,1,1,0,5,0,0,0,7,3,9,1.285714286
Anze Kopitar,LA,C,43,15,22,37,0,82,4,9,13,28,35,166.3,3.86744186
Artem Anisimov,OTT,C,24,7,2,9,-10,40,1,0,1,3,12,44.5,1.854166667
Artemi Panarin,NYR,LW,41,22,33,55,17,120,6,8,14,16,7,214,5.219512195
Artturi Lehkonen,MON,LW,42,9,11,20,8,87,0,0,0,90,24,144.8,3.447619048
Ashton Sautner,VAN,D,1,0,0,0,0,1,0,0,0,0,0,0.4,0.4
Austin Czarnik,CGY,C,8,2,1,3,1,9,1,0,1,1,2,14.6,1.825
Austin Poganski,STL,RW,1,0,0,0,0,0,0,0,0,0,0,0,0
Austin Wagner,LA,LW,39,3,4,7,-2,82,0,0,0,99,9,102.8,2.635897436
Austin Watson,NSH,LW,39,6,7,13,1,43,0,0,0,95,40,117.2,3.005128205
Auston Matthews,TOR,C,43,28,23,51,16,156,7,8,15,24,29,241.9,5.625581395
Barclay Goodrow,SJ,LW,44,7,11,18,3,61,0,0,0,91,45,136.9,3.111363636
Barrett Hayton,ARI,C,14,1,3,4,1,20,0,0,0,10,2,23.5,1.678571429
Beck Malenstyn,FA,C,3,0,0,0,-1,4,0,0,0,5,1,4.1,1.366666667
Beck Malenstyn,WAS,C,3,0,0,0,-1,4,0,0,0,5,1,4.1,1.366666667
Ben Chiarot,MON,D,42,5,8,13,5,87,0,0,0,106,79,160.8,3.828571429
Ben Hutton,LA,D,43,1,5,6,-1,71,0,0,0,32,58,85.9,1.997674419
Ben Street,NJ,C,1,0,0,0,0,3,0,0,0,1,0,1.7,1.7
Blake Coleman,NJ,C,41,13,8,21,4,115,0,0,0,123,30,179.5,4.37804878
Blake Comeau,DAL,LW,28,5,4,9,-2,41,0,0,0,64,10,75.4,2.692857143
Blake Lizotte,LA,LW,43,4,11,15,2,60,1,1,2,27,11,80,1.860465116
Blake Wheeler,WPG,RW,42,14,22,36,-7,107,2,10,12,66,30,185.3,4.411904762
Bo Horvat,VAN,C,42,12,23,35,-4,112,6,4,10,33,42,172.3,4.102380952
Bobby Ryan,OTT,RW,16,1,3,4,0,21,0,0,0,24,3,30.9,1.93125
Boo Nieves,NYR,C,4,0,0,0,2,2,0,0,0,3,2,4.3,1.075
Boone Jenner,CLS,LW,42,8,9,17,-7,100,2,1,3,67,44,137,3.261904762
Brad Hunt,MIN,D,43,7,8,15,-5,79,3,5,8,7,24,89.6,2.08372093
Brad Marchand,BOS,LW,43,20,40,60,18,113,4,15,19,37,9,236.2,5.493023256
Brad Richardson,ARI,C,37,3,3,6,4,41,0,0,0,41,28,67.9,1.835135135
Brady Skjei,NYR,D,40,5,12,17,1,84,0,0,0,60,55,130.6,3.265
Brady Tkachuk,OTT,LW,42,13,11,24,-12,147,2,1,3,167,24,212.3,5.054761905
Brandon Carlo,BOS,D,43,4,9,13,8,68,0,0,0,76,50,124.2,2.888372093
Brandon Davidson,CGY,D,3,0,0,0,-3,8,0,0,0,4,4,5.7,1.9
Brandon Manning,EDM,D,9,1,0,1,-1,8,0,0,0,10,6,13.7,1.522222222
Brandon Montour,BUF,D,29,2,8,10,6,54,0,1,1,31,20,73.1,2.520689655
Brandon Pirri,VGK,C,11,0,1,1,-3,19,0,0,0,9,2,13.6,1.236363636
Brandon Saad,CHI,LW,36,11,8,19,-2,84,0,0,0,25,14,101.1,2.808333333
Brandon Sutter,VAN,C,22,5,3,8,3,44,0,0,0,9,10,49.6,2.254545455
Brandon Tanev,PIT,LW,42,8,11,19,3,63,0,1,1,161,42,175.2,4.171428571
Brayden McNabb,VGK,D,45,2,5,7,0,43,0,0,0,135,78,139.7,3.104444444
Brayden Point,TB,C,38,17,18,35,8,88,7,3,10,12,14,149.2,3.926315789
Brayden Schenn,STL,C,43,17,17,34,-3,87,7,5,12,69,7,168.3,3.913953488
Braydon Coburn,TB,D,20,1,0,1,3,22,0,0,0,28,14,34.3,1.715
Brendan Gallagher,MON,RW,40,15,17,32,5,158,0,4,4,35,28,180.2,4.505
Brendan Gaunce,BOS,C,1,0,1,1,1,0,0,0,0,2,0,3.5,3.5
Brendan Guhle,ANH,D,18,1,3,4,-3,22,0,0,0,8,20,30.3,1.683333333
Brendan Leipsic,WAS,LW,43,3,7,10,7,42,0,1,1,34,12,67.3,1.565116279
Brendan Lemieux,NYR,LW,35,5,8,13,-8,56,1,1,2,86,39,113.9,3.254285714
Brendan Perlini,DET,LW,25,0,2,2,-11,33,0,0,0,15,7,22.7,0.908
Brendan Smith,NYR,D,40,3,3,6,-9,29,0,0,0,61,19,62.1,1.5525
Brenden Dillon,SJ,D,44,1,9,10,-2,42,0,0,0,137,45,127.8,2.904545455
Brennan Menell,MIN,D,5,0,0,0,1,4,0,0,0,2,4,5.1,1.02
Brent Burns,SJ,D,44,7,22,29,-20,127,4,7,11,52,54,169.8,3.859090909
Brent Seabrook,CHI,D,32,3,1,4,1,40,1,0,1,52,61,85,2.65625
Brett Connolly,FLA,RW,42,16,10,26,1,72,4,2,6,41,13,130.3,3.102380952
Brett Howden,NYR,C,41,5,6,11,-8,43,0,0,0,44,39,81.7,1.992682927
Brett Kulak,MON,D,30,0,3,3,-8,49,0,0,0,36,34,56.6,1.886666667
Brett Pesce,CAR,D,42,4,11,15,5,76,0,0,0,17,65,107.9,2.569047619
Brett Ritchie,BOS,RW,23,2,3,5,-5,29,0,1,1,70,2,58.1,2.526086957
Brett Seney,NJ,LW,2,0,0,0,-1,1,0,0,0,2,0,0.9,0.45
Brian Boyle,FLA,C,32,5,7,12,-6,47,1,0,1,53,32,88.3,2.759375
Brian Dumoulin,PIT,D,23,1,6,7,17,33,0,1,1,39,27,70.7,3.073913043
Brian Gibbons,CAR,C,15,0,0,0,-7,9,0,0,0,7,9,8.1,0.54
Brian Lashoff,DET,D,5,0,1,1,0,3,0,0,0,12,6,12.2,2.44
Brock Boeser,VAN,RW,42,13,26,39,2,126,5,9,14,22,9,171.9,4.092857143
Brock McGinn,CAR,LW,42,4,5,9,-3,58,0,0,0,48,15,75.2,1.79047619
Brock Nelson,NYI,C,40,15,16,31,3,119,3,2,5,34,28,162.1,4.0525
Bryan Little,WPG,C,7,2,3,5,4,13,0,0,0,3,3,22.2,3.171428571
Bryan Rust,PIT,RW,28,17,17,34,18,92,4,4,8,37,21,167.8,5.992857143
C.J. Suess,WPG,LW,1,0,0,0,-1,0,0,0,0,1,0,0,0
Cal Clutterbuck,NYI,RW,33,3,4,7,7,34,0,0,0,116,36,110.1,3.336363636
Cale Fleury,MON,D,36,1,0,1,-1,41,0,0,0,86,39,81.4,2.261111111
Cale Makar,COL,D,34,9,23,32,6,72,3,11,14,21,30,144.3,4.244117647
Caleb Jones,EDM,D,19,0,2,2,-5,16,0,0,0,15,21,25.9,1.363157895
Calle Jarnkrok,NSH,C,41,12,15,27,2,93,2,4,6,22,10,126.2,3.07804878
Calle Rosen,COL,D,8,0,2,2,2,10,0,0,0,3,5,13,1.625
Calvin de Haan,CHI,D,29,1,5,6,10,42,0,0,0,93,73,117.8,4.062068966
Cam Atkinson,CLS,RW,35,9,12,21,-5,113,3,5,8,16,20,119.7,3.42
Cam Fowler,ANH,D,42,9,13,22,4,88,2,5,7,20,46,130.2,3.1
Cameron Hughes,BOS,C,1,0,0,0,-1,0,0,0,0,1,2,1,1
Carl Dahlstrom,WPG,D,14,0,0,0,-5,9,0,0,0,5,12,9.6,0.685714286
Carl Grundstrom,LA,LW,9,0,4,4,2,14,0,0,0,20,3,26.1,2.9
Carl Gunnarsson,STL,D,17,1,3,4,1,9,0,0,0,12,21,29.6,1.741176471
Carl Hagelin,WAS,LW,32,1,8,9,7,48,0,0,0,14,9,53.2,1.6625
Carl Soderberg,ARI,C,44,12,13,25,6,65,4,4,8,47,21,133,3.022727273
Carsen Twarynski,PHI,LW,15,1,0,1,-2,14,0,0,0,40,8,31.6,2.106666667
Carson Soucy,MIN,D,40,5,5,10,15,41,0,0,0,43,31,85.9,2.1475
Carter Rowney,ANH,C,42,5,4,9,-2,46,0,0,0,120,23,111.9,2.664285714
Carter Verhaeghe,TB,C,28,2,4,6,-4,33,0,0,0,11,2,31.7,1.132142857
Casey Cizikas,NYI,C,35,8,4,12,10,52,0,0,0,104,28,123.8,3.537142857
Casey Mittelstadt,BUF,C,31,4,5,9,-5,34,1,1,2,11,8,44.6,1.438709677
Cedric Paquette,TB,C,33,4,7,11,-7,48,0,0,0,105,28,108.2,3.278787879
Chad Ruhwedel,PIT,D,19,2,3,5,3,23,0,0,0,46,8,49.7,2.615789474
Chandler Stephenson,VGK,RW,40,8,5,13,16,37,1,1,2,37,21,87.8,2.195
Charles Hudon,MON,LW,9,0,1,1,-4,14,0,0,0,15,1,13.6,1.511111111
Charlie Coyle,BOS,C,43,7,13,20,-1,85,0,2,2,48,19,116,2.697674419
Charlie McAvoy,BOS,D,40,0,13,13,9,55,0,1,1,90,80,138.5,3.4625
Chris Kreider,NYR,LW,41,12,14,26,4,94,3,3,6,79,31,164.6,4.014634146
Chris Stewart,PHI,RW,15,0,1,1,-7,4,0,0,0,35,4,19.6,1.306666667
Chris Tanev,VAN,D,42,2,10,12,4,29,0,1,1,21,97,99.6,2.371428571
Chris Tierney,OTT,C,42,6,16,22,-6,50,1,0,1,29,21,93,2.214285714
Chris Wagner,BOS,RW,41,3,4,7,-6,42,0,0,0,113,16,95.3,2.324390244
Christian Djoos,WAS,D,2,0,0,0,1,1,0,0,0,0,0,0.9,0.45
Christian Dvorak,ARI,LW,44,10,15,25,7,84,3,3,6,28,26,130.1,2.956818182
Christian Fischer,ARI,RW,39,5,3,8,6,65,0,0,0,94,17,105.5,2.705128205
Christian Folin,MON,D,5,0,1,1,2,2,0,0,0,14,9,15.3,3.06
Christian Jaros,OTT,D,5,0,2,2,-1,1,0,0,0,11,5,11.9,2.38
Christoffer Ehn,DET,C,31,1,0,1,-13,17,0,0,0,31,11,24.3,0.783870968
Clark Bishop,CAR,C,5,0,1,1,-2,4,0,0,0,5,0,5.1,1.02
Claude Giroux,PHI,C,42,13,17,30,9,135,4,7,11,35,12,166,3.952380952
Clayton Keller,ARI,C,44,12,20,32,-1,129,2,10,12,13,8,149.6,3.4
Cody Ceci,TOR,D,43,1,6,7,9,35,0,0,0,64,69,100,2.325581395
Cody Eakin,VGK,C,24,3,4,7,-6,38,0,1,1,19,9,44.2,1.841666667
Cody Glass,VGK,C,37,5,7,12,-7,49,1,5,6,15,6,61.6,1.664864865
Cody Goloubef,OTT,D,16,0,1,1,-3,9,0,0,0,32,19,29.6,1.85
Colby Cave,EDM,C,5,1,0,1,-1,2,0,0,0,12,0,9.3,1.86
Cole Bardreau,NYI,LW,9,1,1,2,-1,9,0,0,0,19,1,18.1,2.011111111
Colin Blackwell,NSH,C,10,0,3,3,6,12,0,0,0,24,5,28.3,2.83
Colin Miller,BUF,D,31,1,5,6,-4,49,0,3,3,52,27,73.1,2.358064516
Colin White,OTT,C,35,3,7,10,-9,48,0,1,1,21,18,58.2,1.662857143
Colin Wilson,COL,LW,9,0,4,4,6,12,0,0,0,8,2,20.8,2.311111111
Colton Parayko,STL,D,42,2,11,13,3,93,0,2,2,56,75,134.2,3.195238095
Colton Sceviour,FLA,RW,42,5,7,12,-1,69,0,0,0,46,37,97.6,2.323809524
Colton Sissons,NSH,RW,37,7,6,13,1,38,0,0,0,60,26,91.7,2.478378378
Connor Brown,OTT,RW,42,7,18,25,1,100,0,1,1,16,26,119.5,2.845238095
Connor Bunnaman,PHI,C,4,0,0,0,0,4,0,0,0,5,1,4.6,1.15
Connor Carrick,NJ,D,6,0,1,1,-3,4,0,0,0,7,8,9.6,1.6
Connor Clifton,BOS,D,30,2,0,2,4,20,0,0,0,85,32,74.5,2.483333333
Connor McDavid,EDM,C,44,23,42,65,-5,138,9,20,29,27,17,256.7,5.834090909
Connor Murphy,CHI,D,31,4,7,11,1,59,0,0,0,71,71,121.1,3.906451613
Conor Garland,ARI,RW,43,14,8,22,4,102,3,3,6,20,16,124.8,2.902325581
Conor Sheary,BUF,LW,36,7,7,14,3,62,1,1,2,21,18,82.8,2.3
Conor Timmins,COL,D,2,0,0,0,2,1,0,0,0,0,0,1.4,0.7
Corey Perry,DAL,RW,34,3,10,13,0,42,0,3,3,29,18,72.3,2.126470588
Cory Conacher,TB,LW,4,0,1,1,-2,5,0,0,0,3,1,5,1.25
Craig Smith,NSH,RW,41,10,10,20,14,110,1,2,3,36,10,127,3.097560976
Curtis Lazar,BUF,C,13,3,1,4,-1,8,0,0,0,28,8,31.7,2.438461538
Dale Weise,MON,RW,2,0,0,0,-1,0,0,0,0,6,1,3,1.5
Dalton Prout,SJ,D,2,0,0,0,0,2,0,0,0,3,3,3.8,1.9
Dalton Smith,BUF,LW,1,0,0,0,1,0,0,0,0,0,0,0.5,0.5
Damon Severson,NJ,D,41,4,8,12,-12,58,0,1,1,46,54,96.2,2.346341463
Dan Hamhuis,NSH,D,37,0,5,5,7,21,0,0,0,44,34,60.9,1.645945946
Daniel Carr,NSH,LW,11,1,0,1,-5,14,0,0,0,10,2,12.1,1.1
Daniel Sprong,ANH,RW,2,1,1,2,-1,5,1,0,1,0,0,7.5,3.75
Danil Yurtaikin,SJ,LW,4,0,0,0,-1,2,0,0,0,3,2,2.8,0.7
Danny DeKeyser,DET,D,8,0,4,4,0,12,0,0,0,6,18,24.8,3.1
Dante Fabbro,NSH,D,39,4,5,9,0,54,1,0,1,31,50,85.1,2.182051282
Danton Heinen,BOS,C,42,6,9,15,2,58,3,2,5,18,26,87.2,2.076190476
Darnell Nurse,EDM,D,44,3,17,20,-4,102,0,2,2,88,76,165.8,3.768181818
Darren Helm,DET,C,42,6,4,10,1,56,0,0,0,59,18,87.4,2.080952381
David Backes,BOS,RW,15,1,2,3,-2,26,1,0,1,21,3,29.4,1.96
David Gustafsson,WPG,C,22,1,0,1,-2,4,0,0,0,5,6,9.1,0.413636364
David Kampf,CHI,RW,43,6,6,12,-9,58,0,0,0,33,18,74.2,1.725581395
David Kase,PHI,RW,5,1,0,1,1,5,0,0,0,3,1,7.5,1.5
David Krejci,BOS,C,36,8,20,28,13,45,2,8,10,27,20,122,3.388888889
David Pastrnak,BOS,RW,43,31,30,61,12,170,15,11,26,37,13,278,6.465116279
David Perron,STL,RW,43,17,26,43,0,103,6,16,22,48,12,196.2,4.562790698
David Savard,CLS,D,40,0,7,7,2,50,0,0,0,75,90,117.5,2.9375
Dean Kukan,CLS,D,33,1,4,5,-9,51,1,0,1,24,28,53.9,1.633333333
Denis Gurianov,DAL,RW,37,9,6,15,2,78,3,2,5,35,12,99.7,2.694594595
Denis Malgin,FLA,C,30,3,6,9,-6,43,1,0,1,21,12,52.7,1.756666667
Dennis Cholowski,DET,D,29,2,6,8,-22,43,1,4,5,14,27,49.7,1.713793103
Dennis Gilbert,CHI,D,19,1,2,3,-8,12,0,0,0,69,32,58.3,3.068421053
Derek Grant,ANH,C,34,9,3,12,-2,50,1,0,1,31,17,77,2.264705882
Derek Ryan,CGY,C,44,7,15,22,8,72,0,3,3,10,20,101.8,2.313636364
Derek Stepan,ARI,C,44,7,9,16,-5,93,1,5,6,26,28,106.7,2.425
Derick Brassard,NYI,C,40,8,13,21,1,68,2,4,6,66,17,125.2,3.13
Derrick Pouliot,STL,D,2,0,0,0,-1,1,0,0,0,2,1,1.4,0.7
Deryk Engelland,VGK,D,40,1,5,6,9,48,0,0,0,101,72,123.2,3.08
Devin Shore,ANH,C,26,2,4,6,-1,33,0,2,2,30,10,48.7,1.873076923
Devon Toews,NYI,D,40,3,10,13,0,71,1,2,3,29,41,95.4,2.385
Dillon Dube,CGY,C,20,3,5,8,3,23,0,0,0,20,4,41.7,2.085
Dmitry Kulikov,WPG,D,25,1,3,4,2,28,0,0,0,40,38,60.2,2.408
Dmitry Orlov,WAS,D,43,3,17,20,3,68,1,4,5,66,52,135.7,3.155813953
Dmytro Timashov,TOR,LW,30,3,5,8,1,23,0,0,0,69,8,67.2,2.24
Dominic Toninato,FLA,LW,24,4,2,6,3,21,0,0,0,27,14,46.4,1.933333333
Dominik Kahun,PIT,C,41,9,12,21,9,63,0,1,1,5,15,91.7,2.236585366
Dominik Kubalik,CHI,LW,41,12,10,22,1,87,2,3,5,57,13,131.3,3.202439024
Dominik Simon,PIT,C,42,4,12,16,-4,75,0,1,1,31,12,86.5,2.05952381
Dougie Hamilton,CAR,D,42,13,24,37,27,157,2,10,12,45,56,225.8,5.376190476
Drake Batherson,OTT,RW,3,0,1,1,-5,1,0,1,1,2,4,3.9,1.3
Drake Caggiula,CHI,LW,15,3,1,4,-2,15,0,0,0,37,7,38,2.533333333
Drew Doughty,LA,D,43,6,20,26,-10,98,4,7,11,81,63,175.2,4.074418605
Dryden Hunt,FLA,LW,20,0,4,4,0,32,0,0,0,35,6,41.3,2.065
Duncan Keith,CHI,D,34,1,10,11,-2,55,0,3,3,18,67,89.5,2.632352941
Dustin Brown,LA,RW,39,8,11,19,0,94,0,2,2,84,7,131.1,3.361538462
Dylan DeMelo,OTT,D,32,0,6,6,7,42,0,0,0,56,43,81.8,2.55625
Dylan Gambrell,SJ,C,30,2,4,6,-11,19,0,1,1,19,20,36.6,1.22
Dylan Larkin,DET,C,43,10,17,27,-16,132,4,4,8,29,29,145.8,3.390697674
Dylan McIlrath,DET,D,16,0,0,0,-4,14,0,0,0,48,12,33.6,2.1
Dylan Sikura,CHI,LW,6,1,2,3,0,9,0,0,0,0,1,11.1,1.85
Dylan Strome,CHI,C,39,10,20,30,3,64,2,5,7,16,15,119.6,3.066666667
Eetu Luostarinen,CAR,LW,8,0,1,1,-2,9,0,0,0,9,2,10.1,1.2625
Elias Lindholm,CGY,RW,44,16,16,32,-11,103,6,6,12,54,28,168.7,3.834090909
Elias Pettersson,VAN,C,42,19,25,44,3,107,6,12,18,40,24,201.3,4.792857143
Emil Bemstrom,CLS,C,28,3,6,9,-2,39,2,1,3,26,8,55.6,1.985714286
Eric Robinson,CLS,LW,22,4,4,8,6,28,0,0,0,42,8,59.2,2.690909091
Eric Staal,MIN,C,43,16,17,33,-7,76,5,3,8,19,15,133.9,3.113953488
Erik Brannstrom,OTT,D,31,0,4,4,-9,38,0,1,1,15,36,45.2,1.458064516
Erik Cernak,TB,D,38,2,4,6,0,76,0,0,0,93,52,116.9,3.076315789
Erik Gudbranson,ANH,D,38,3,4,7,2,54,0,0,0,68,39,93.1,2.45
Erik Gustafsson,CHI,D,42,5,13,18,-4,74,2,5,7,57,33,120.6,2.871428571
Erik Haula,CAR,C,23,11,6,17,1,50,3,3,6,8,5,78,3.391304348
Erik Johnson,COL,D,31,1,8,9,2,54,0,0,0,54,63,100.1,3.229032258
Erik Karlsson,SJ,D,43,4,26,30,-15,95,1,8,9,22,55,142,3.302325581
Esa Lindell,DAL,D,42,2,14,16,8,57,1,4,5,46,75,126.3,3.007142857
Ethan Bear,EDM,D,44,4,10,14,-4,56,1,0,1,38,61,102.9,2.338636364
Evan Rodrigues,BUF,C,24,0,3,3,-5,38,0,0,0,14,8,29.7,1.2375
Evander Kane,SJ,LW,41,18,14,32,-3,135,9,3,12,92,15,200,4.87804878
Evgeni Malkin,PIT,C,29,11,28,39,14,104,2,8,10,11,14,160.1,5.520689655
Evgenii Dadonov,FLA,RW,42,18,16,34,4,110,8,2,10,21,15,160,3.80952381
Evgeny Kuznetsov,WAS,C,40,16,24,40,4,86,6,6,12,20,13,160.9,4.0225
Evgeny Svechnikov,DET,LW,4,0,0,0,-1,7,0,0,0,5,1,5.3,1.325
Filip Chlapik,OTT,C,18,2,3,5,-1,17,0,0,0,30,3,34.8,1.933333333
Filip Chytil,NYR,C,32,10,4,14,4,68,1,0,1,6,20,81.2,2.5375
Filip Forsberg,NSH,RW,35,14,14,28,-1,115,3,4,7,49,7,150.5,4.3
Filip Hronek,DET,D,41,8,15,23,-18,82,1,6,7,68,53,145.3,3.543902439
Filip Zadina,DET,LW,18,4,6,10,-4,32,2,3,5,4,5,44.3,2.461111111
Frank Vatrano,FLA,LW,42,9,9,18,-6,97,1,0,1,59,32,127.3,3.030952381
Frans Nielsen,DET,C,38,1,3,4,-7,58,0,0,0,24,21,51.2,1.347368421
Frederik Gauthier,TOR,C,39,4,4,8,1,27,0,0,0,45,14,60.8,1.558974359
Gabriel Bourque,WPG,LW,28,2,3,5,0,24,0,0,0,68,24,67.6,2.414285714
Gabriel Carlsson,CLS,D,6,0,0,0,-1,3,0,0,0,5,0,3.2,0.533333333
Gabriel Dumont,MIN,C,3,0,0,0,-1,3,0,0,0,9,2,6.2,2.066666667
Gabriel Landeskog,COL,LW,26,10,7,17,-7,68,4,3,7,54,15,109.2,4.2
Gaetan Haas,EDM,C,36,4,4,8,-1,34,0,1,1,37,22,63.6,1.766666667
Garnet Hathaway,WAS,RW,40,6,6,12,7,48,0,0,0,106,29,120.2,3.005
Gemel Smith,TB,C,3,1,0,1,0,1,0,0,0,1,2,4.9,1.633333333
Gerald Mayhew,MIN,C,7,2,0,2,2,9,0,0,0,5,2,14.1,2.014285714
German Rubtsov,PHI,C,3,0,0,0,-1,1,0,0,0,2,4,2.9,0.966666667
Givani Smith,DET,LW,7,0,0,0,0,7,0,0,0,13,0,9.3,1.328571429
Greg McKegg,NYR,C,28,1,3,4,-3,21,0,0,0,37,7,37.9,1.353571429
Gustav Nyquist,CLS,RW,42,9,19,28,5,90,2,5,7,19,13,126.5,3.011904762
Gustav Olofsson,MON,D,3,0,0,0,-4,2,0,0,0,1,6,2.3,0.766666667
Hampus Lindholm,ANH,D,34,1,16,17,-10,59,1,5,6,17,44,90.1,2.65
Haydn Fleury,CAR,D,23,2,3,5,-4,32,0,0,0,19,19,41.8,1.817391304
Henri Jokiharju,BUF,D,43,4,7,11,1,56,1,0,1,43,37,89.9,2.090697674
Henrik Borgstrom,FLA,C,4,0,0,0,-2,3,0,0,0,1,0,0.7,0.175
Ian Cole,COL,D,37,4,16,20,24,44,0,0,0,48,82,138.6,3.745945946
Ilya Kovalchuk,MON,RW,17,3,6,9,-10,35,1,2,3,12,9,43.5,2.558823529
Ilya Lyubushkin,ARI,D,30,0,2,2,2,29,0,0,0,91,32,78.1,2.603333333
Ilya Mikheyev,TOR,RW,39,8,15,23,7,98,0,0,0,26,13,116.2,2.979487179
Isac Lundestrom,ANH,LW,11,0,3,3,-2,7,0,1,1,4,6,13.8,1.254545455
Ivan Barbashev,STL,LW,41,5,11,16,1,45,0,0,0,90,24,112.5,2.743902439
Ivan Provorov,PHI,D,42,9,15,24,2,96,6,7,13,47,69,167.4,3.985714286
J.T. Compher,COL,C,39,5,16,21,12,61,1,2,3,23,31,107.4,2.753846154
J.T. Miller,VAN,C,42,15,25,40,2,105,7,9,16,70,25,201.5,4.797619048
Jaccob Slavin,CAR,D,42,4,17,21,25,93,0,0,0,25,68,142.2,3.385714286
Jack Eichel,BUF,C,42,26,29,55,10,147,6,10,16,27,31,244.8,5.828571429
Jack Hughes,NJ,C,36,6,10,16,-10,77,3,3,6,7,12,79.3,2.202777778
Jack Johnson,PIT,D,40,2,5,7,6,39,0,0,0,106,47,111.1,2.7775
Jack Roslovic,WPG,RW,42,7,10,17,6,67,1,1,2,37,11,96.8,2.304761905
Jack Studnicka,BOS,C,2,0,1,1,2,3,0,0,0,2,0,5.2,2.6
Jacob De La Rose,STL,C,40,2,6,8,3,41,0,0,0,88,15,87.4,2.185
Jacob Larsson,ANH,D,32,1,3,4,-8,32,0,0,0,17,29,40.8,1.275
Jacob Middleton,SJ,D,4,0,0,0,0,2,0,0,0,5,2,4.3,1.075
Jacob Trouba,NYR,D,41,6,15,21,-4,109,3,4,7,102,72,183.6,4.47804878
Jaden Schwartz,STL,LW,43,14,22,36,-2,96,6,7,13,31,25,164.4,3.823255814
Jake Bischoff,VGK,D,4,0,0,0,-2,6,0,0,0,8,8,9.4,2.35
Jake DeBrusk,BOS,LW,38,11,9,20,0,86,5,1,6,18,9,104.9,2.760526316
Jake Gardiner,CAR,D,42,2,7,9,-21,52,0,4,4,35,28,65.8,1.566666667
Jake Guentzel,PIT,LW,39,20,23,43,11,127,6,4,10,46,19,204.8,5.251282051
Jake McCabe,BUF,D,41,2,5,7,-3,46,0,0,0,60,61,93.4,2.27804878
Jake Muzzin,TOR,D,38,3,10,13,8,69,0,0,0,87,69,138.6,3.647368421
Jake Virtanen,VAN,LW,42,12,12,24,0,82,3,2,5,70,15,140.3,3.34047619
Jake Walman,STL,D,1,0,0,0,1,1,0,0,0,0,1,1.4,1.4
Jakob Chychrun,ARI,D,44,10,9,19,3,95,4,2,6,49,67,151.5,3.443181818
Jakob Lilja,CLS,LW,17,1,2,3,1,16,0,0,0,9,14,25.4,1.494117647
Jakob Silfverberg,ANH,RW,41,15,13,28,-1,91,3,3,6,23,20,134.4,3.27804878
Jakub Voracek,PHI,LW,42,8,25,33,7,69,2,9,11,13,14,129.6,3.085714286
Jakub Vrana,WAS,RW,43,18,16,34,8,123,0,6,6,16,11,158.7,3.690697674
James Neal,EDM,RW,44,19,8,27,-22,96,12,5,17,61,12,153.9,3.497727273
James van Riemsdyk,PHI,LW,42,12,11,23,4,104,2,1,3,16,8,116.6,2.776190476
Jamie Benn,DAL,C,42,9,11,20,-1,109,3,3,6,105,39,170.1,4.05
Jamie Oleksiak,DAL,D,42,1,5,6,2,50,0,0,0,82,35,92.5,2.202380952
Jan Rutta,TB,D,21,1,3,4,3,30,0,0,0,17,14,38,1.80952381
Jansen Harkins,WPG,C,7,0,2,2,-1,5,0,0,0,2,3,8,1.142857143
Jared McCann,PIT,C,40,11,13,24,12,86,1,2,3,63,18,142.9,3.5725
Jared Spurgeon,MIN,D,36,3,14,17,-8,60,0,4,4,29,65,108,3
Jarred Tinordi,NSH,D,3,0,0,0,1,2,0,0,0,16,1,9.8,3.266666667
Jason Demers,ARI,D,36,0,5,5,2,39,0,0,0,50,49,76.1,2.113888889
Jason Dickinson,DAL,C,38,5,7,12,6,44,0,0,0,59,33,95.6,2.515789474
Jason Spezza,TOR,C,31,5,11,16,-2,37,1,4,5,7,11,64.8,2.090322581
Jason Zucker,MIN,LW,34,12,12,24,-4,61,4,3,7,27,20,112.9,3.320588235
Jay Beagle,VAN,C,33,1,2,3,-6,30,0,0,0,41,23,48,1.454545455
Jay Bouwmeester,STL,D,43,1,5,6,2,41,0,0,0,36,53,74.9,1.741860465
Jayce Hawryluk,FLA,C,9,1,2,3,-1,5,0,0,0,18,5,20,2.222222222
Jayson Megna,COL,LW,8,0,0,0,-1,4,0,0,0,10,5,8.6,1.075
Jean-Christophe Beaudin,OTT,C,22,0,1,1,-4,18,0,0,0,51,11,38.2,1.736363636
Jean-Gabriel Pageau,OTT,C,42,19,11,30,16,99,1,4,5,81,35,189.6,4.514285714
Jean-Sebastien Dea,BUF,C,1,0,0,0,0,0,0,0,0,0,0,0,0
Jeff Carter,LA,C,43,12,8,20,-12,135,2,2,4,41,17,133,3.093023256
Jeff Petry,MON,D,42,6,19,25,-6,100,2,6,8,107,47,178,4.238095238
Jeff Skinner,BUF,LW,39,11,8,19,-9,128,0,3,3,17,9,111.7,2.864102564
Jeremy Lauzon,BOS,D,1,0,0,0,-1,2,0,0,0,1,2,1.8,1.8
Jesper Boqvist,NJ,C,27,4,0,4,-7,33,1,0,1,33,12,45.2,1.674074074
Jesper Bratt,NJ,LW,35,8,7,15,-5,51,0,0,0,12,11,67.4,1.925714286
Jesper Fast,NYR,RW,40,6,8,14,9,48,0,0,0,66,26,103.7,2.5925
Jesperi Kotkaniemi,MON,C,27,5,2,7,-9,42,1,1,2,44,10,60.3,2.233333333
Jimmy Vesey,BUF,LW,40,5,8,13,10,59,0,0,0,18,11,74.1,1.8525
Joachim Blichfeld,SJ,LW,2,0,0,0,-1,1,0,0,0,3,2,2.4,1.2
Joakim Nordstrom,BOS,C,31,4,1,5,-3,37,0,0,0,60,15,64.8,2.090322581
Joakim Nygard,EDM,LW,27,2,4,6,-1,33,1,0,1,17,7,39.7,1.47037037
Joakim Ryan,LA,D,27,1,2,3,-4,32,0,0,0,14,35,42.3,1.566666667
Joe Hicketts,DET,D,6,0,2,2,-5,6,0,0,0,14,13,17.4,2.9
Joe Pavelski,DAL,RW,42,8,10,18,4,82,3,2,5,38,30,117.8,2.804761905
Joe Thornton,SJ,C,44,1,17,18,-8,45,0,3,3,13,16,68.5,1.556818182
Joel Armia,MON,RW,35,12,9,21,6,110,3,1,4,92,18,160,4.571428571
Joel Edmundson,CAR,D,42,3,7,10,4,57,0,0,0,69,57,110.8,2.638095238
Joel Eriksson Ek,MIN,C,36,3,14,17,2,58,0,0,0,64,30,108.2,3.005555556
Joel Farabee,PHI,LW,33,3,9,12,-1,51,0,0,0,22,12,63.9,1.936363636
Joel Hanley,DAL,D,8,0,2,2,0,4,0,0,0,3,8,11.1,1.3875
Joel Kellman,SJ,C,8,1,1,2,0,6,0,0,0,8,5,13.9,1.7375
Joel Kiviranta,DAL,RW,1,0,0,0,0,3,0,0,0,0,0,1.2,1.2
Joel L'Esperance,DAL,C,3,1,0,1,0,2,0,0,0,1,1,4.8,1.6
Joel Persson,EDM,D,13,0,2,2,-1,17,0,0,0,6,10,18.3,1.407692308
Johan Larsson,BUF,C,37,4,8,12,8,37,0,0,0,48,20,80.8,2.183783784
John Carlson,WAS,D,43,13,39,52,16,124,2,14,16,36,71,244.1,5.676744186
John Gilmour,BUF,D,4,0,0,0,-2,5,0,0,0,3,3,4,1
John Hayden,NJ,C,18,1,1,2,-2,16,0,0,0,36,10,33.4,1.855555556
John Klingberg,DAL,D,34,2,16,18,-9,63,1,9,10,21,43,100.7,2.961764706
John Marino,PIT,D,40,4,15,19,14,53,1,2,3,57,58,130.7,3.2675
John Moore,BOS,D,12,1,1,2,-3,19,0,0,0,16,14,26.1,2.175
John Quenneville,CHI,C,6,0,0,0,0,10,0,0,0,14,2,12,2
John Tavares,TOR,C,36,16,20,36,2,114,3,8,11,12,19,161.1,4.475
Johnny Boychuk,NYI,D,39,2,8,10,1,61,1,0,1,83,78,128.4,3.292307692
Johnny Gaudreau,CGY,LW,44,11,24,35,-11,114,3,8,11,1,6,135.6,3.081818182
Jon Merrill,VGK,D,37,1,3,4,3,30,0,0,0,38,56,69.5,1.878378378
Jonas Brodin,MIN,D,43,1,16,17,10,59,0,0,0,32,57,108.1,2.513953488
Jonas Siegenthaler,WAS,D,43,2,6,8,9,30,0,0,0,37,73,89.5,2.081395349
Jonathan Davidsson,OTT,RW,6,0,1,1,0,3,0,0,0,5,1,6.2,1.033333333
Jonathan Drouin,MON,C,19,7,8,15,4,44,1,3,4,22,4,73.6,3.873684211
Jonathan Ericsson,DET,D,9,0,0,0,-7,8,0,0,0,13,4,8.2,0.911111111
Jonathan Huberdeau,FLA,LW,42,17,40,57,13,95,3,16,19,33,14,218,5.19047619
Jonathan Marchessault,VGK,LW,43,15,16,31,-3,153,3,5,8,74,9,186.2,4.330232558
Jonathan Toews,CHI,C,43,10,21,31,-6,105,1,3,4,33,25,144,3.348837209
Jonny Brodzinski,SJ,RW,3,0,1,1,0,5,0,0,0,3,0,5.5,1.833333333
Joona Luoto,WPG,RW,16,0,0,0,-3,9,0,0,0,10,8,11.1,0.69375
Joonas Donskoi,COL,RW,42,14,15,29,0,81,4,1,5,14,24,128.4,3.057142857
Jordan Eberle,NYI,RW,30,3,14,17,-3,64,1,4,5,15,15,81.1,2.703333333
Jordan Greenway,MIN,LW,41,5,11,16,-2,50,0,1,1,63,24,100.5,2.451219512
Jordan Gross,ARI,D,2,0,1,1,2,3,0,0,0,0,1,4.7,2.35
Jordan Kyrou,STL,RW,10,2,2,4,2,14,0,1,1,5,3,21.6,2.16
Jordan Martinook,CAR,LW,27,2,7,9,-4,26,0,0,0,39,13,54.4,2.014814815
Jordan Oesterle,ARI,D,35,1,7,8,-2,44,0,1,1,28,55,76.1,2.174285714
Jordan Staal,CAR,C,42,6,10,16,3,85,2,1,3,91,19,131.5,3.130952381
Jordan Szwarz,OTT,RW,3,0,0,0,0,2,0,0,0,6,1,4.3,1.433333333
Jordan Weal,MON,C,34,4,3,7,-8,50,2,1,3,24,18,58,1.705882353
Jordie Benn,VAN,D,37,0,6,6,-4,50,0,0,0,30,54,72,1.945945946
Joseph Blandisi,PIT,C,21,2,3,5,-3,12,0,0,0,26,9,32.8,1.561904762
Josh Anderson,CLS,RW,26,1,3,4,-8,63,0,0,0,68,13,70.7,2.719230769
Josh Archibald,EDM,RW,35,3,3,6,-11,37,0,0,0,87,19,77.3,2.208571429
Josh Bailey,NYI,LW,40,8,15,23,-9,53,1,5,6,15,28,98.2,2.455
Josh Brown,FLA,D,37,2,2,4,3,28,0,0,0,46,41,66.2,1.789189189
Josh Leivo,VAN,LW,36,7,12,19,0,69,0,5,5,17,8,90.1,2.502777778
Josh Mahura,ANH,D,11,1,3,4,-3,11,0,0,0,2,11,18.4,1.672727273
Josh Manson,ANH,D,23,0,3,3,-5,29,0,0,0,52,28,55.1,2.395652174
Josh Morrissey,WPG,D,40,3,20,23,-2,78,1,8,9,22,38,118.2,2.955
Jujhar Khaira,EDM,C,40,6,2,8,-14,48,0,0,0,82,15,82.7,2.0675
Julien Gauthier,CAR,RW,5,0,1,1,2,1,0,0,0,4,0,5.4,1.08
Justin Abdelkader,DET,LW,26,0,3,3,-2,23,0,0,0,55,18,50.7,1.95
Justin Braun,PHI,D,42,2,8,10,-10,52,0,0,0,60,59,97.3,2.316666667
Justin Dowling,DAL,C,24,3,3,6,0,25,0,0,0,24,10,42,1.75
Justin Faulk,STL,D,43,3,9,12,-3,96,0,2,2,49,42,111.4,2.590697674
Justin Holl,TOR,D,41,1,11,12,17,50,0,0,0,48,33,94,2.292682927
Justin Schultz,PIT,D,27,2,6,8,-5,62,0,3,3,26,22,67.3,2.492592593
Juuso Riikola,PIT,D,20,1,4,5,3,27,0,1,1,44,16,54.3,2.715
Kaapo Kakko,NYR,RW,37,7,9,16,-15,62,2,8,10,11,8,75.8,2.048648649
Kailer Yamamoto,EDM,LW,3,1,1,2,3,6,0,0,0,11,1,14.9,4.966666667
Kale Clague,LA,D,4,0,0,0,-3,2,0,0,0,1,4,1.8,0.45
Karson Kuhlman,BOS,C,8,0,0,0,-2,13,0,0,0,9,3,10.2,1.275
Kasperi Kapanen,TOR,RW,43,10,14,24,0,72,0,3,3,55,10,122.3,2.844186047
Keith Yandle,FLA,D,42,4,28,32,2,85,2,15,17,12,39,145.5,3.464285714
Kevin Connauton,COL,D,1,0,0,0,0,2,0,0,0,3,1,2.8,2.8
Kevin Fiala,MIN,LW,38,9,16,25,2,80,2,4,6,20,11,113.5,2.986842105
Kevin Gravel,TOR,D,3,0,0,0,0,2,0,0,0,2,3,3.3,1.1
Kevin Hayes,PHI,C,42,12,11,23,-8,106,2,2,4,58,14,136.4,3.247619048
Kevin Labanc,SJ,RW,44,9,12,21,-22,107,2,3,5,29,9,106.8,2.427272727
Kevin Rooney,NJ,C,22,0,1,1,-1,19,0,0,0,23,11,26.1,1.186363636
Kevin Shattenkirk,TB,D,41,7,19,26,11,84,1,5,6,36,40,142.1,3.465853659
Kevin Stenlund,CLS,C,10,2,0,2,-3,18,2,0,2,7,11,22.7,2.27
Kirby Dach,CHI,C,37,6,5,11,-1,51,0,1,1,15,13,62.9,1.7
Klim Kostin,STL,RW,4,1,0,1,1,5,0,0,0,6,0,8.5,2.125
Kole Sherwood,CLS,C,3,0,0,0,0,6,0,0,0,10,1,7.9,2.633333333
Korbinian Holzer,ANH,D,34,1,2,3,-2,31,0,0,0,71,66,86.9,2.555882353
Kris Letang,PIT,D,34,10,16,26,6,102,3,5,8,53,52,166.3,4.891176471
Kris Russell,EDM,D,43,0,4,4,-1,37,0,0,0,59,88,95.8,2.227906977
Kurtis MacDermid,LA,D,26,2,2,4,0,32,0,0,0,53,26,62.3,2.396153846
Kyle Capobianco,ARI,D,7,1,0,1,-1,6,0,0,0,8,9,13.4,1.914285714
Kyle Clifford,LA,LW,42,5,6,11,-1,65,0,0,0,65,8,89,2.119047619
Kyle Connor,WPG,LW,42,21,20,41,-4,147,7,3,10,12,7,179.3,4.269047619
Kyle Okposo,BUF,RW,32,4,4,8,-1,43,0,0,0,30,9,56.2,1.75625
Kyle Palmieri,NJ,RW,41,15,13,28,2,98,7,4,11,51,18,156.7,3.82195122
Kyle Turris,NSH,C,34,5,12,17,-4,52,2,2,4,7,10,70.3,2.067647059
Lars Eller,WAS,C,43,10,15,25,4,103,2,2,4,37,30,140.7,3.272093023
Lawson Crouse,ARI,LW,40,9,5,14,-4,60,0,0,0,124,14,128,3.2
Lean Bergmann,SJ,LW,8,0,1,1,-5,9,0,0,0,10,4,10.1,1.2625
Leo Komarov,NYI,LW,21,0,6,6,5,19,0,0,0,55,9,54.1,2.576190476
Leon Draisaitl,EDM,C,44,24,41,65,-17,130,7,20,27,18,14,240.5,5.465909091
Lias Andersson,NYR,LW,17,0,1,1,-8,13,0,0,0,20,8,17.2,1.011764706
Libor Hajek,NYR,D,27,0,5,5,-2,22,0,0,0,23,42,50.3,1.862962963
Logan Brown,OTT,C,23,1,7,8,0,23,1,2,3,13,11,41.2,1.791304348
Logan Couture,SJ,C,44,14,22,36,0,109,0,8,8,47,37,179.6,4.081818182
Logan O'Connor,COL,C,7,1,0,1,3,8,0,0,0,3,4,11.2,1.6
Logan Shaw,WPG,RW,25,2,1,3,-1,12,0,0,0,17,11,26.3,1.052
Loui Eriksson,VAN,RW,23,2,2,4,3,26,0,0,0,1,8,26.4,1.147826087
Luca Sbisa,WPG,D,30,2,5,7,1,39,0,0,0,62,51,88.6,2.953333333
Lucas Wallmark,CAR,C,42,8,11,19,-5,59,3,3,6,34,16,98.1,2.335714286
Lukas Radil,SJ,LW,14,0,0,0,-3,12,0,0,0,16,2,12.3,0.878571429
Lukas Vejdemo,MON,C,3,0,0,0,-1,2,0,0,0,2,1,1.8,0.6
Luke Glendening,DET,RW,32,6,3,9,-11,52,0,0,0,95,37,105.3,3.290625
Luke Johnson,MIN,C,3,0,0,0,-3,1,0,0,0,6,0,1.9,0.633333333
Luke Kunin,MIN,C,42,10,9,19,-10,87,0,1,1,44,37,119.3,2.84047619
Luke Schenn,TB,D,15,1,0,1,-9,13,0,0,0,42,11,30.2,2.013333333
Luke Witkowski,TB,RW,12,1,2,3,-4,10,0,0,0,38,3,29.5,2.458333333
Mackenzie MacEachern,STL,LW,36,6,2,8,0,48,0,0,0,61,8,75.7,2.102777778
MacKenzie Weegar,FLA,D,28,3,9,12,2,46,0,0,0,46,38,88.4,3.157142857
Madison Bowey,DET,D,32,2,10,12,-11,37,0,0,0,33,31,67.3,2.103125
Marc Staal,NYR,D,25,2,3,5,3,23,0,0,0,33,42,60.2,2.408
Marc-Edouard Vlasic,SJ,D,44,5,5,10,-7,44,0,0,0,25,60,81.6,1.854545455
Marco Scandella,MON,D,32,3,6,9,9,40,0,0,0,42,37,81,2.53125
Marcus Foligno,MIN,LW,33,7,9,16,7,49,0,0,0,116,18,129.1,3.912121212
Marcus Johansson,BUF,LW,36,6,15,21,-4,42,1,4,5,29,13,88.8,2.466666667
Marcus Pettersson,PIT,D,42,1,14,15,6,46,0,1,1,63,40,104.9,2.497619048
Marcus Sorensen,SJ,RW,41,5,5,10,-10,47,0,0,0,34,14,62.8,1.531707317
Mario Ferraro,SJ,D,38,1,6,7,-8,36,0,0,0,71,27,74.4,1.957894737
Mark Barberio,COL,D,14,0,2,2,7,21,0,0,0,11,15,28.9,2.064285714
Mark Borowiecki,OTT,D,42,5,11,16,5,50,0,0,0,170,93,191,4.547619048
Mark Giordano,CGY,D,44,5,15,20,1,111,2,4,6,30,110,165.9,3.770454545
Mark Jankowski,CGY,C,35,0,1,1,-13,19,0,0,0,11,17,17.1,0.488571429
Mark Letestu,WPG,C,7,0,0,0,0,5,0,0,0,3,5,6,0.857142857
Mark Pysyk,FLA,D,32,2,4,6,-4,32,0,0,0,22,25,48.3,1.509375
Mark Scheifele,WPG,C,42,20,28,48,1,106,7,9,16,27,29,202.9,4.830952381
Mark Stone,VGK,RW,45,16,25,41,4,121,6,5,11,40,32,195.4,4.342222222
Marko Dano,CLS,C,3,0,0,0,-1,2,0,0,0,5,3,4.3,1.433333333
Markus Granlund,EDM,C,31,3,1,4,-1,23,0,0,0,15,18,36.2,1.167741935
Markus Nutivaara,CLS,D,10,2,0,2,-1,14,0,0,0,12,11,22.6,2.26
Martin Fehervary,WAS,D,3,0,0,0,0,4,0,0,0,6,0,4.6,1.533333333
Martin Frk,LA,RW,4,3,0,3,0,7,1,0,1,3,1,14.8,3.7
Martin Marincin,TOR,D,11,0,0,0,5,10,0,0,0,9,16,19,1.727272727
Martin Necas,CAR,C,38,9,14,23,-3,54,3,2,5,35,14,104.6,2.752631579
Mason Appleton,WPG,C,17,0,1,1,-4,18,0,0,0,10,7,15.7,0.923529412
Mason Marchment,TOR,LW,2,0,0,0,0,1,0,0,0,2,0,1.4,0.7
Mathew Barzal,NYI,C,40,16,18,34,7,90,3,3,6,12,28,149.5,3.7375
Mathew Dumba,MIN,D,43,3,10,13,-8,99,0,5,5,65,59,131.6,3.060465116
Mathieu Joseph,TB,RW,34,4,3,7,-2,32,0,0,0,40,8,53.8,1.582352941
Mathieu Olivier,NSH,RW,8,0,1,1,1,6,0,0,0,17,1,13.9,1.7375
Mathieu Perreault,WPG,C,36,6,6,12,-3,55,1,0,1,49,16,84,2.333333333
Mats Zuccarello,MIN,RW,39,10,13,23,-9,64,3,3,6,10,22,99.1,2.541025641
Matt Benning,EDM,D,24,0,5,5,8,18,0,0,0,50,20,56.2,2.341666667
Matt Calvert,COL,LW,35,10,12,22,13,66,0,0,0,46,18,118.9,3.397142857
Matt Duchene,NSH,C,38,9,19,28,-3,87,4,4,8,24,11,123.8,3.257894737
Matt Grzelcyk,BOS,D,42,2,9,11,1,74,0,5,5,38,42,99.1,2.35952381
Matt Irwin,NSH,D,22,0,2,2,-6,29,0,0,0,41,25,45.6,2.072727273
Matt Luff,LA,RW,15,1,4,5,-2,20,0,0,0,10,5,25.5,1.7
Matt Martin,NYI,LW,28,3,2,5,3,22,0,0,0,133,10,94.8,3.385714286
Matt Nieto,COL,LW,42,6,12,18,10,58,0,0,0,24,13,88.7,2.111904762
Matt Niskanen,PHI,D,41,5,12,17,-2,79,3,5,8,77,46,139.1,3.392682927
Matt Roy,LA,D,43,4,9,13,3,76,0,0,0,65,62,125.4,2.91627907
Matt Tennyson,NJ,D,19,0,3,3,-1,12,0,0,0,27,17,32.3,1.7
Matthew Highmore,CHI,C,14,1,1,2,-1,13,0,0,0,11,3,16.7,1.192857143
Matthew Peca,MON,C,4,0,0,0,-1,4,0,0,0,2,1,2.6,0.65
Matthew Tkachuk,CGY,LW,43,15,21,36,-8,116,3,9,12,84,11,188.9,4.393023256
Mattias Ekholm,NSH,D,40,5,18,23,2,94,0,3,3,29,63,138.6,3.465
Mattias Janmark,DAL,C,36,5,9,14,0,44,1,2,3,15,25,73.6,2.044444444
Max Domi,MON,C,42,12,20,32,6,111,1,9,10,16,6,144.4,3.438095238
Max Jones,ANH,LW,31,4,2,6,-3,56,0,0,0,36,10,59.9,1.932258065
Max Lajoie,OTT,D,6,0,0,0,0,3,0,0,0,2,3,3.7,0.616666667
Max Pacioretty,VGK,LW,45,18,25,43,10,181,5,9,14,57,23,235.4,5.231111111
Max Veronneau,OTT,RW,4,0,0,0,-2,3,0,0,0,2,2,2.2,0.55
Maxime Comtois,ANH,LW,26,4,5,9,-5,29,2,1,3,59,8,67.6,2.6
Melker Karlsson,SJ,C,40,3,4,7,-9,26,0,0,0,32,28,52.9,1.3225
Michael Amadio,LA,C,41,6,8,14,-5,70,0,3,3,16,14,77.5,1.890243902
Michael Dal Colle,NYI,LW,29,2,2,4,-2,24,0,0,0,40,10,43.6,1.503448276
Michael Del Zotto,ANH,D,28,1,6,7,3,31,0,1,1,63,35,78.9,2.817857143
Michael Frolik,BUF,LW,38,5,5,10,-10,44,0,0,0,19,11,52.6,1.384210526
Michael Grabner,ARI,RW,39,8,3,11,1,55,0,0,0,18,9,66,1.692307692
Michael McLeod,NJ,C,4,0,2,2,1,3,0,0,0,3,2,8.2,2.05
Michael Raffl,PHI,LW,32,3,6,9,-8,32,0,0,0,41,14,57.3,1.790625
Michael Sgarbossa,WAS,LW,2,0,0,0,0,1,0,0,0,3,0,1.9,0.95
Michael Stone,CGY,D,22,2,2,4,-3,35,0,0,0,33,35,56.5,2.568181818
Michal Kempny,WAS,D,33,3,11,14,9,37,0,0,0,19,49,84.3,2.554545455
Micheal Ferland,VAN,LW,14,1,4,5,-3,15,0,0,0,40,2,36.5,2.607142857
Micheal Haley,NYR,LW,18,1,0,1,-5,9,0,0,0,28,6,21.1,1.172222222
Miikka Salomaki,NSH,RW,5,1,0,1,2,2,0,0,0,9,3,10.8,2.16
Mika Zibanejad,NYR,C,28,16,15,31,2,94,6,3,9,27,24,151.1,5.396428571
Mikael Backlund,CGY,C,44,6,14,20,3,87,2,3,5,27,7,104.3,2.370454545
Mikael Granlund,NSH,C,35,6,8,14,-3,76,0,1,1,23,25,87.9,2.511428571
Mike Green,DET,D,34,2,5,7,-22,58,1,2,3,32,51,72.7,2.138235294
Mike Hoffman,FLA,LW,42,14,17,31,-3,116,5,8,13,16,11,147.4,3.50952381
Mike Matheson,FLA,D,36,4,6,10,-3,69,0,1,1,31,34,83.6,2.322222222
Mike Reilly,OTT,D,15,0,4,4,1,24,0,0,0,14,16,33.1,2.206666667
Mikhail Sergachev,TB,D,41,6,15,21,2,67,4,4,8,58,56,140.8,3.434146341
Mikhail Vorobyov,PHI,C,18,1,2,3,-4,13,0,0,0,4,3,13.7,0.761111111
Mikkel Boedker,OTT,LW,7,0,1,1,1,5,0,0,0,2,1,6,0.857142857
Mikko Koivu,MIN,C,31,2,11,13,1,50,1,6,7,10,18,69.5,2.241935484
Mikko Rantanen,COL,RW,26,15,16,31,-3,68,6,3,9,18,13,127.2,4.892307692
Milan Lucic,CGY,LW,42,4,6,10,-4,53,3,1,4,112,12,109.2,2.6
Miles Wood,NJ,LW,41,5,6,11,-18,77,0,0,0,65,14,88.3,2.153658537
Mirco Mueller,NJ,D,28,1,0,1,-11,16,0,0,0,33,45,42.9,1.532142857
Miro Heiskanen,DAL,D,42,7,15,22,9,108,0,4,4,19,58,141.2,3.361904762
Mitch Marner,TOR,C,32,11,29,40,3,83,5,9,14,10,23,156.2,4.88125
Mitchell Stephens,TB,C,13,2,0,2,-4,16,0,0,0,12,3,17.9,1.376923077
Morgan Frost,PHI,C,18,2,5,7,-4,31,0,0,0,4,3,29.9,1.661111111
Morgan Rielly,TOR,D,43,3,22,25,7,115,0,7,7,36,60,157.5,3.662790698
Nate Schmidt,VGK,D,33,4,13,17,1,64,0,3,3,16,58,104.1,3.154545455
Nate Thompson,MON,C,42,2,7,9,-1,44,0,0,0,68,34,88.1,2.097619048
Nathan Beaulieu,WPG,D,21,0,4,4,5,13,0,0,0,34,24,44.7,2.128571429
Nathan Gerbe,CLS,LW,6,1,2,3,0,11,0,0,0,13,0,17.9,2.983333333
Nathan MacKinnon,COL,C,42,25,39,64,3,194,8,15,23,31,19,280.1,6.669047619
Nathan Walker,STL,C,5,1,1,2,-2,6,0,0,0,10,1,11.9,2.38
Nazem Kadri,COL,C,39,15,12,27,2,104,3,5,8,56,6,150.6,3.861538462
Neal Pionk,WPG,D,42,3,24,27,6,91,1,14,15,93,43,179.4,4.271428571
Nic Dowd,WAS,C,30,5,5,10,10,21,0,0,0,47,11,67.4,2.246666667
Nick Bjugstad,PIT,C,10,1,0,1,2,16,0,0,0,19,6,22.9,2.29
Nick Bonino,NSH,C,41,13,11,24,14,74,1,0,1,12,43,126.1,3.075609756
Nick Caamano,DAL,RW,12,1,1,2,2,13,0,0,0,17,3,21.2,1.766666667
Nick Cousins,MON,C,36,5,8,13,1,75,2,1,3,52,21,101,2.805555556
Nick Foligno,CLS,LW,39,4,12,16,-5,74,2,1,3,125,26,141.6,3.630769231
Nick Holden,VGK,D,35,4,3,7,-2,54,1,0,1,81,45,102.6,2.931428571
Nick Jensen,WAS,D,43,0,2,2,-6,41,0,1,1,43,45,62.4,1.451162791
Nick Leddy,NYI,D,32,3,14,17,2,42,1,3,4,35,43,97.8,3.05625
Nick Paul,OTT,LW,37,6,7,13,0,63,0,1,1,85,22,111.7,3.018918919
Nick Ritchie,ANH,LW,27,3,7,10,-3,49,1,1,2,46,9,70.6,2.614814815
Nick Schmaltz,ARI,RW,44,7,28,35,9,56,2,7,9,9,21,127.9,2.906818182
Nick Seeler,MIN,D,6,0,0,0,-6,4,0,0,0,5,9,5.6,0.933333333
Nick Shore,WPG,C,34,3,2,5,2,20,0,0,0,25,12,40.5,1.191176471
Nick Suzuki,MON,C,42,7,17,24,-2,70,2,5,7,29,17,112,2.666666667
Nicklas Backstrom,WAS,C,35,8,24,32,-6,78,1,10,11,20,21,131.7,3.762857143
Nico Hischier,NJ,C,36,9,15,24,-7,75,2,6,8,31,22,118,3.277777778
Nico Sturm,MIN,C,6,0,2,2,2,2,0,0,0,6,5,11.3,1.883333333
Nicolas Aube-Kubel,PHI,C,9,1,2,3,-2,21,1,0,1,22,5,28.9,3.211111111
Nicolas Deslauriers,ANH,LW,30,1,4,5,-3,30,0,0,0,75,13,65.5,2.183333333
Nicolas Hague,VGK,D,32,0,9,9,1,41,0,3,3,59,22,78.4,2.45
Nicolas Petan,TOR,C,16,0,3,3,-4,19,0,0,0,7,4,17.1,1.06875
Nicolas Roy,VGK,C,9,2,3,5,4,9,0,0,0,16,2,26.6,2.955555556
Nikita Gusev,NJ,LW,38,7,17,24,-8,88,2,3,5,8,4,97.2,2.557894737
Nikita Kucherov,TB,RW,40,14,31,45,10,110,3,15,18,21,14,188.5,4.7125
Nikita Zadorov,COL,D,38,1,4,5,2,39,0,0,0,110,46,105.6,2.778947368
Nikita Zaitsev,OTT,D,32,0,8,8,-1,35,0,0,0,55,74,94,2.9375
Niklas Hjalmarsson,ARI,D,4,1,0,1,1,4,0,0,0,2,4,8.1,2.025
Nikolaj Ehlers,WPG,LW,42,16,16,32,5,118,3,0,3,19,16,150.2,3.576190476
Nikolay Goldobin,VAN,RW,1,0,0,0,0,0,0,0,0,1,0,0.5,0.5
Nikolay Prokhorkin,LA,LW,23,4,7,11,0,32,0,1,1,22,2,51.8,2.252173913
Nino Niederreiter,CAR,RW,42,5,15,20,-6,68,2,6,8,27,15,98.2,2.338095238
Noah Dobson,NYI,D,13,0,2,2,1,11,0,0,0,11,7,17.9,1.376923077
Noah Gregor,SJ,C,18,1,0,1,-5,17,0,0,0,24,3,20.8,1.155555556
Noah Hanifin,CGY,D,44,4,7,11,-16,87,1,2,3,59,61,115.8,2.631818182
Noel Acciari,FLA,C,39,14,3,17,-2,59,0,0,0,72,64,138.6,3.553846154
Oliver Bjorkstrand,CLS,RW,36,12,11,23,1,122,2,3,5,31,15,135.3,3.758333333
Oliver Ekman-Larsson,ARI,D,44,4,13,17,3,95,0,3,3,81,49,145.5,3.306818182
Oliver Kylington,CGY,D,31,1,3,4,-3,24,0,0,0,22,25,40.6,1.309677419
Oliver Wahlstrom,NYI,RW,9,0,0,0,-2,9,0,0,0,10,4,9.6,1.066666667
Olli Maatta,CHI,D,38,2,9,11,-2,49,0,0,0,76,67,114.1,3.002631579
Ondrej Kase,ANH,RW,36,3,11,14,-6,94,0,1,1,8,7,74.1,2.058333333
Ondrej Palat,TB,LW,41,12,13,25,15,89,3,4,7,96,37,178.6,4.356097561
Oscar Fantenberg,VAN,D,15,1,1,2,-1,20,0,1,1,25,29,40.5,2.7
Oscar Klefbom,EDM,D,44,4,21,25,-19,116,2,13,15,34,138,191.9,4.361363636
Oskar Lindblom,PHI,LW,30,11,7,18,4,72,3,1,4,31,16,105.3,3.51
Oskar Sundqvist,STL,C,37,10,7,17,3,65,0,0,0,42,18,101.5,2.743243243
Otto Koivula,NYI,C,6,0,0,0,0,2,0,0,0,7,3,5.8,0.966666667
Otto Leskinen,MON,D,5,0,0,0,0,2,0,0,0,13,1,7.8,1.56
P.K. Subban,NJ,D,41,4,5,9,-12,95,0,1,1,53,52,107.5,2.62195122
Par Lindholm,BOS,C,26,2,0,2,1,20,0,0,0,13,14,28,1.076923077
Patric Hornqvist,PIT,RW,25,9,6,15,6,76,1,1,2,58,25,115.9,4.636
Patrice Bergeron,BOS,C,34,17,19,36,11,121,6,8,14,26,26,182.9,5.379411765
Patrick Kane,CHI,RW,43,24,30,54,1,154,6,10,16,15,12,223.6,5.2
Patrick Marleau,SJ,LW,40,7,8,15,-4,70,1,0,1,38,12,89,2.225
Patrick Maroon,TB,LW,39,5,8,13,-4,54,1,1,2,64,6,87.6,2.246153846
Patrick Russell,EDM,RW,30,0,4,4,-2,39,0,0,0,41,18,52.1,1.736666667
Patrik Laine,WPG,RW,40,15,25,40,7,133,3,5,8,58,21,199.2,4.98
Patrik Nemeth,DET,D,37,1,6,7,-7,56,0,0,0,44,49,80.4,2.172972973
Paul Byron,MON,C,19,1,3,4,3,11,0,0,0,28,11,34.4,1.810526316
Paul Carey,BOS,RW,1,0,0,0,-1,0,0,0,0,0,1,0,0
Paul LaDue,LA,D,2,0,1,1,0,2,0,0,0,2,3,5.3,2.65
Paul Stastny,VGK,C,45,11,8,19,-6,80,4,3,7,48,24,121,2.688888889
Pavel Buchnevich,NYR,LW,41,7,16,23,-3,72,1,4,5,49,14,116.8,2.848780488
Pavel Zacha,NJ,C,37,3,14,17,-18,47,0,1,1,26,11,66.3,1.791891892
Peter Cehlarik,BOS,C,3,0,1,1,-1,0,0,0,0,2,2,3.5,1.166666667
Phil Kessel,ARI,RW,44,9,15,24,-18,102,6,6,12,10,16,113.8,2.586363636
Philippe Myers,PHI,D,24,3,8,11,17,26,0,0,0,38,22,73.9,3.079166667
Phillip Danault,MON,C,42,10,20,30,9,75,1,3,4,79,23,159.5,3.797619048
Pierre Engvall,TOR,LW,21,6,4,10,6,31,0,0,0,13,4,49.9,2.376190476
Pierre-Edouard Bellemare,COL,C,41,7,9,16,9,46,0,0,0,25,26,87.4,2.131707317
Pierre-Luc Dubois,CLS,C,42,14,14,28,-2,100,1,6,7,55,33,160,3.80952381
Pontus Aberg,TOR,LW,3,0,1,1,0,2,0,0,0,0,1,3.3,1.1
Quinn Hughes,VAN,D,41,4,26,30,-5,74,3,13,16,4,28,123.1,3.002439024
Radek Faksa,DAL,C,42,9,7,16,-4,75,2,0,2,56,25,111.5,2.654761905
Radim Simek,SJ,D,22,1,6,7,-11,17,0,0,0,52,24,54.3,2.468181818
Radko Gudas,WAS,D,43,1,12,13,18,57,0,0,0,117,53,143.8,3.344186047
Rasmus Andersson,CGY,D,44,3,9,12,-11,84,0,3,3,30,55,100.6,2.286363636
Rasmus Asplund,BUF,C,25,1,2,3,-1,32,0,0,0,17,7,31.3,1.252
Rasmus Dahlin,BUF,D,35,2,20,22,-1,52,1,10,11,40,24,109.3,3.122857143
Rasmus Ristolainen,BUF,D,43,4,15,19,0,88,1,2,3,133,51,172.2,4.004651163
Rasmus Sandin,TOR,D,6,0,2,2,0,5,0,0,0,5,3,10,1.666666667
Reilly Smith,VGK,RW,45,16,18,34,6,110,2,2,4,29,21,160,3.555555556
Rhett Gardner,DAL,C,8,0,0,0,0,8,0,0,0,8,2,8.2,1.025
Richard Panik,WAS,RW,33,5,2,7,9,41,0,0,0,38,11,64.4,1.951515152
Rickard Rakell,ANH,C,36,10,15,25,2,103,2,4,6,44,12,136.2,3.783333333
Riley Barber,MON,RW,9,0,0,0,-1,6,0,0,0,15,1,9.9,1.1
Riley Nash,CLS,C,37,3,6,9,2,36,0,0,0,36,19,63.9,1.727027027
Riley Sheahan,EDM,C,39,4,2,6,-9,37,0,0,0,19,10,40.8,1.046153846
Riley Stillman,FLA,D,9,0,2,2,-1,18,0,0,0,10,17,24.2,2.688888889
Robby Fabbri,DET,LW,35,10,9,19,-21,57,5,3,8,37,7,90.3,2.58
Robert Bortuzzo,STL,D,24,0,2,2,8,17,0,0,0,33,26,44.3,1.845833333
Robert Hagg,PHI,D,23,0,3,3,-1,19,0,0,0,69,38,66.6,2.895652174
Robert Thomas,STL,C,38,7,14,21,8,50,1,0,1,10,6,82,2.157894737
Rocco Grimaldi,NSH,C,38,8,14,22,9,69,0,0,0,16,7,95.6,2.515789474
Roman Josi,NSH,D,41,14,30,44,19,148,4,11,15,31,67,234.7,5.724390244
Roman Polak,DAL,D,22,0,4,4,6,16,0,0,0,57,60,75.9,3.45
Ron Hainsey,OTT,D,36,1,7,8,3,27,0,0,0,30,51,69.8,1.938888889
Roope Hintz,DAL,LW,35,14,7,21,4,63,1,6,7,43,17,120.2,3.434285714
Ross Johnston,NYI,LW,24,3,0,3,0,12,0,0,0,75,11,56.8,2.366666667
Rudolfs Balcers,OTT,LW,2,0,0,0,0,2,0,0,0,1,0,1.3,0.65
Ryan Carpenter,CHI,C,42,2,9,11,-6,48,0,0,0,77,32,94.7,2.254761905
Ryan Donato,MIN,C,40,8,5,13,2,63,0,0,0,27,7,77.2,1.93
Ryan Dzingel,CAR,C,42,8,17,25,3,75,4,4,8,23,15,116.5,2.773809524
Ryan Ellis,NSH,D,39,6,22,28,15,90,0,6,6,39,72,167,4.282051282
Ryan Getzlaf,ANH,C,40,10,18,28,-5,93,2,3,5,69,42,161.2,4.03
Ryan Graves,COL,D,41,6,9,15,31,78,0,0,0,70,83,159.2,3.882926829
Ryan Hartman,MIN,RW,43,5,6,11,0,65,0,0,0,25,36,83.5,1.941860465
Ryan Johansen,NSH,C,41,9,17,26,-3,60,3,6,9,27,20,116,2.829268293
Ryan Lindgren,NYR,D,31,1,7,8,5,23,0,0,0,51,35,71.7,2.312903226
Ryan MacInnis,CLS,C,7,0,1,1,1,11,0,0,0,7,2,11.4,1.628571429
Ryan McDonagh,TB,D,40,1,10,11,2,41,0,0,0,27,80,93.9,2.3475
Ryan Murray,CLS,D,24,2,5,7,-7,29,0,1,1,12,43,52.6,2.191666667
Ryan Nugent-Hopkins,EDM,LW,38,9,16,25,-7,87,4,10,14,23,24,127.8,3.363157895
Ryan O'Reilly,STL,C,43,8,30,38,1,74,2,12,14,14,25,147.6,3.43255814
Ryan Poehling,MON,C,15,0,0,0,-2,12,0,0,0,24,8,19.8,1.32
Ryan Pulock,NYI,D,40,6,14,20,0,95,2,5,7,51,74,153.5,3.8375
Ryan Reaves,VGK,RW,45,5,3,8,1,40,0,0,0,190,15,140,3.111111111
Ryan Strome,NYR,C,41,11,26,37,9,68,1,7,8,22,17,144.2,3.517073171
Ryan Suter,MIN,D,43,6,24,30,-7,67,2,10,12,35,58,147.8,3.437209302
Sam Bennett,CGY,LW,28,4,2,6,2,47,0,1,1,59,8,70.3,2.510714286
Sam Carrick,ANH,C,9,1,1,2,-3,16,0,0,0,13,8,20.4,2.266666667
Sam Gagner,EDM,C,21,1,7,8,-7,37,0,1,1,13,6,38.8,1.847619048
Sam Lafferty,PIT,RW,32,4,6,10,5,38,0,0,0,66,14,81.7,2.553125
Sam Reinhart,BUF,C,43,14,20,34,-6,88,2,5,7,30,12,142.2,3.306976744
Sam Steel,ANH,C,37,3,11,14,-11,46,1,5,6,17,15,65.9,1.781081081
Sami Niku,WPG,D,1,0,0,0,0,1,0,0,0,2,3,2.9,2.9
Sami Vatanen,NJ,D,37,5,17,22,-5,76,1,9,10,46,63,141.4,3.821621622
Sammy Blais,STL,LW,20,5,3,8,2,29,0,0,0,70,6,71.6,3.58
Samuel Girard,COL,D,42,1,21,22,-5,58,1,8,9,33,60,121.2,2.885714286
Samuel Morin,PHI,D,1,0,0,0,-1,0,0,0,0,2,0,0.5,0.5
Scott Harrington,CLS,D,14,0,2,2,-5,14,0,0,0,18,17,24.6,1.757142857
Scott Laughton,PHI,C,22,5,5,10,-1,31,0,0,0,50,12,67.9,3.086363636
Scott Mayfield,NYI,D,39,4,7,11,9,58,0,0,0,62,75,122.2,3.133333333
Scott Sabourin,OTT,RW,14,1,2,3,-2,11,0,0,0,33,7,30.4,2.171428571
Scott Wilson,BUF,LW,1,0,0,0,-1,1,0,0,0,0,0,-0.1,-0.1
Sean Couturier,PHI,C,42,12,22,34,10,107,2,6,8,33,21,162.8,3.876190476
Sean Kuraly,BOS,C,43,3,12,15,-1,60,0,1,1,89,19,111.5,2.593023256
Sean Monahan,CGY,C,44,14,20,34,-12,113,4,7,11,47,15,163.2,3.709090909
Sean Walker,LA,D,43,4,12,16,1,73,0,2,2,53,60,124.2,2.888372093
Sebastian Aho,CAR,LW,42,23,14,37,10,123,5,6,11,31,11,183.2,4.361904762
Seth Jones,CLS,D,42,4,20,24,4,97,1,6,7,48,89,168.3,4.007142857
Shayne Gostisbehere,PHI,D,39,5,7,12,-5,68,1,4,5,14,34,82.7,2.120512821
Shea Theodore,VGK,D,45,6,19,25,5,125,0,9,9,15,47,148.5,3.3
Shea Weber,MON,D,42,12,19,31,7,123,3,4,7,70,77,207.2,4.933333333
Sheldon Dries,COL,C,1,0,0,0,-1,0,0,0,0,7,2,4,4
Sidney Crosby,PIT,C,17,5,12,17,-1,46,1,2,3,17,7,71.9,4.229411765
Slater Koekkoek,CHI,D,16,0,3,3,-4,12,0,0,0,31,17,32.8,2.05
Sonny Milano,CLS,LW,32,4,9,13,-3,46,0,1,1,20,7,61.4,1.91875
Stefan Noesen,SJ,C,14,2,0,2,-3,16,0,0,0,30,5,28.4,2.028571429
Steve Kampfer,BOS,D,8,0,2,2,1,9,0,2,2,14,8,21.1,2.6375
Steve Santini,NSH,D,2,0,0,0,1,1,0,0,0,3,0,2.4,1.2
Steven Fogarty,NYR,C,4,0,0,0,-1,1,0,0,0,1,2,1.4,0.35
Steven Stamkos,TB,C,38,16,23,39,-4,120,7,8,15,40,24,187,4.921052632
Sven Baertschi,VAN,LW,6,0,2,2,-2,7,0,2,2,5,0,10.3,1.716666667
T.J. Brodie,CGY,D,38,1,12,13,4,37,0,1,1,11,55,77.8,2.047368421
T.J. Oshie,WAS,RW,43,16,15,31,0,83,7,1,8,53,38,164.7,3.830232558
T.J. Tynan,COL,C,14,0,1,1,-1,7,0,0,0,7,3,9.3,0.664285714
Tage Thompson,BUF,RW,1,0,0,0,0,0,0,0,0,2,0,1,1
Tanner Pearson,VAN,LW,42,12,18,30,5,104,2,6,8,58,24,165.1,3.930952381
Taro Hirose,DET,LW,23,2,5,7,-11,16,0,5,5,11,12,33.4,1.452173913
Taylor Fedun,DAL,D,24,2,7,9,3,37,0,0,0,14,17,51.8,2.158333333
Taylor Hall,ARI,LW,39,8,23,31,-14,133,2,11,13,32,11,150.7,3.864102564
Teddy Blueger,PIT,C,42,5,8,13,1,58,0,0,0,59,22,95.2,2.266666667
Teuvo Teravainen,CAR,C,42,8,33,41,14,119,3,14,17,12,14,174.6,4.157142857
Thomas Chabot,OTT,D,42,4,21,25,-14,113,0,7,7,51,56,152.7,3.635714286
Thomas Di Pauli,PIT,C,2,0,0,0,-3,2,0,0,0,4,1,1.8,0.9
Tim Gettinger,NYR,LW,2,0,1,1,1,3,0,0,0,5,1,6.7,3.35
Tim Heed,SJ,D,24,0,1,1,-2,26,0,0,0,15,20,28.9,1.204166667
Tim Schaller,VAN,C,40,4,0,4,-9,40,0,0,0,40,24,55.5,1.3875
Timo Meier,SJ,LW,44,14,14,28,-9,112,1,2,3,97,27,175.3,3.984090909
Tobias Bjornfot,LA,D,3,0,0,0,-4,0,0,0,0,0,0,-2,-0.666666667
Tobias Rieder,CGY,RW,35,2,5,7,-9,45,0,0,0,21,12,46,1.314285714
Tom Kuhnhackl,NYI,RW,14,2,1,3,-1,15,0,0,0,9,13,24.5,1.75
Tom Wilson,WAS,RW,42,13,14,27,5,87,1,2,3,151,38,201.8,4.804761905
Tomas Hertl,SJ,LW,40,15,18,33,-20,94,2,5,7,22,21,137.1,3.4275
Tomas Jurco,EDM,RW,12,0,2,2,1,7,0,0,0,4,3,10.8,0.9
Tomas Nosek,VGK,LW,41,5,4,9,2,61,0,0,0,59,21,88.4,2.156097561
Tomas Tatar,MON,LW,42,16,19,35,-6,103,7,3,10,54,14,168.2,4.004761905
Torey Krug,BOS,D,35,5,23,28,0,72,1,16,17,22,29,132.3,3.78
Travis Boyd,WAS,C,19,2,6,8,7,19,0,1,1,10,7,38.6,2.031578947
Travis Dermott,TOR,D,30,4,4,8,8,38,0,0,0,36,32,73.2,2.44
Travis Hamonic,CGY,D,38,3,5,8,0,61,0,0,0,25,79,95.4,2.510526316
Travis Konecny,PHI,C,39,12,24,36,-2,89,2,11,13,36,16,157.6,4.041025641
Travis Sanheim,PHI,D,42,4,8,12,1,66,0,1,1,19,42,86.4,2.057142857
Travis Zajac,NJ,C,41,5,8,13,-1,41,0,0,0,46,24,81.9,1.997560976
Trent Frederic,BOS,C,2,0,0,0,-1,1,0,0,0,8,0,3.9,1.95
Trevor Carrick,SJ,D,3,0,0,0,0,1,0,0,0,1,0,0.9,0.3
Trevor Daley,DET,D,22,0,1,1,-13,19,0,0,0,6,24,18.1,0.822727273
Trevor Lewis,LA,C,30,1,5,6,-1,50,0,0,0,42,14,60.5,2.016666667
Trevor Moore,TOR,LW,22,3,2,5,-1,36,0,0,0,48,12,56.9,2.586363636
Trevor van Riemsdyk,CAR,D,24,0,3,3,-7,28,0,0,0,13,19,29.7,1.2375
Troy Brouwer,STL,RW,10,1,0,1,1,9,0,0,0,19,5,19.1,1.91
Troy Stecher,VAN,D,42,2,5,7,6,48,0,0,0,48,38,81.2,1.933333333
Troy Terry,ANH,C,33,3,5,8,-7,42,0,0,0,2,5,35.8,1.084848485
Tucker Poolman,WPG,D,40,2,10,12,-1,46,0,0,0,38,42,83.9,2.0975
Tyler Bertuzzi,DET,LW,43,15,16,31,-11,85,2,7,9,43,22,147,3.418604651
Tyler Bozak,STL,C,42,8,11,19,4,64,1,1,2,24,21,98.1,2.335714286
Tyler Ennis,OTT,LW,42,11,13,24,-2,87,3,2,5,42,17,127.3,3.030952381
Tyler Graovac,VAN,C,8,2,0,2,-2,5,2,0,2,6,3,13.5,1.6875
Tyler Johnson,TB,C,36,9,10,19,-1,68,0,5,5,43,7,103.7,2.880555556
Tyler Lewington,WAS,D,6,0,0,0,-2,2,0,0,0,13,7,9.8,1.633333333
Tyler Motte,VAN,C,15,2,1,3,-2,13,0,0,0,58,17,49.7,3.313333333
Tyler Myers,VAN,D,42,4,10,14,-1,83,1,4,5,53,60,126.2,3.004761905
Tyler Pitlick,PHI,C,36,4,5,9,-1,40,0,0,0,64,19,79,2.194444444
Tyler Seguin,DAL,C,42,11,21,32,6,150,1,6,7,57,19,183,4.357142857
Tyler Toffoli,LA,RW,42,11,13,24,-5,104,2,3,5,23,6,117.6,2.8
Tyson Barrie,TOR,D,43,4,18,22,-3,112,1,4,5,30,42,132.3,3.076744186
Tyson Jost,COL,C,39,5,8,13,10,69,0,2,2,30,10,85.6,2.194871795
Urho Vaakanainen,BOS,D,5,0,0,0,2,2,0,0,0,8,3,7.3,1.46
Valentin Zykov,VGK,RW,15,1,3,4,-2,19,1,0,1,20,3,28.1,1.873333333
Valeri Nichushkin,COL,LW,37,7,8,15,14,67,0,0,0,44,13,99.3,2.683783784
Valtteri Filppula,DET,C,42,3,11,14,-29,41,0,2,2,20,15,52.4,1.247619048
Victor Hedman,TB,D,39,9,30,39,8,94,3,16,19,50,54,199.6,5.117948718
Victor Mete,MON,D,32,3,5,8,6,39,0,0,0,13,39,63.6,1.9875
Victor Olofsson,BUF,LW,42,16,19,35,-1,99,9,5,14,8,15,150.6,3.585714286
Victor Rask,MIN,C,33,4,6,10,8,29,0,0,0,19,7,52.6,1.593939394
Viktor Arvidsson,NSH,LW,29,9,9,18,2,65,3,2,5,17,10,90.5,3.120689655
Ville Heinola,WPG,D,8,1,4,5,3,10,0,1,1,3,5,21.5,2.6875
Vince Dunn,STL,D,43,6,7,13,8,84,3,3,6,28,25,102.1,2.374418605
Vincent Trocheck,FLA,C,35,5,17,22,3,86,0,4,4,50,24,125.9,3.597142857
Vinnie Hinostroza,ARI,C,43,4,13,17,5,74,0,1,1,29,17,94.1,2.188372093
Vitali Abramov,OTT,RW,2,1,0,1,0,3,0,0,0,0,0,4.2,2.1
Vladimir Sobotka,BUF,C,16,1,2,3,2,23,0,0,0,26,7,33.7,2.10625
Vladimir Tarasenko,STL,RW,10,3,7,10,-2,26,1,2,3,17,7,47.4,4.74
Vladislav Gavrikov,CLS,D,41,4,3,7,4,50,0,0,0,45,49,87,2.12195122
Vladislav Kamenev,COL,C,18,1,4,5,2,18,0,1,1,10,9,29.7,1.65
Vladislav Namestnikov,OTT,C,39,8,10,18,-8,62,1,2,3,68,30,116.8,2.994871795
Warren Foegele,CAR,LW,42,8,11,19,12,86,0,0,0,47,11,115.4,2.747619048
Wayne Simmonds,NJ,RW,41,4,10,14,-14,86,3,1,4,92,18,118.4,2.887804878
Will Butcher,NJ,D,38,4,8,12,-13,43,0,1,1,23,47,74.7,1.965789474
William Carrier,VGK,LW,45,5,8,13,4,70,0,0,0,131,7,130,2.888888889
William Karlsson,VGK,C,45,10,23,33,6,95,2,3,5,31,32,153.5,3.411111111
William Lagesson,EDM,D,2,0,0,0,-1,2,0,0,0,0,3,1.8,0.9
William Nylander,TOR,C,43,19,19,38,8,115,4,6,10,7,9,163,3.790697674
Yakov Trenin,NSH,C,8,2,2,4,5,11,0,0,0,16,2,25.9,3.2375
Yanni Gourde,TB,LW,41,6,12,18,-3,73,1,4,5,42,15,103.2,2.517073171
Yannick Weber,NSH,D,22,0,1,1,2,23,0,0,0,18,12,27.2,1.236363636
Zac Rinaldo,CGY,C,8,2,1,3,-1,10,0,0,0,27,2,26,3.25
Zach Aston-Reese,PIT,C,42,5,6,11,4,80,0,0,0,94,23,119.5,2.845238095
Zach Bogosian,BUF,D,14,0,4,4,3,12,0,0,0,15,18,30.8,2.2
Zach Hyman,TOR,RW,24,10,6,16,8,55,2,1,3,17,11,85,3.541666667
Zach Parise,MIN,LW,43,14,12,26,-9,96,5,3,8,19,28,131.4,3.055813953
Zach Sanford,STL,LW,30,3,7,10,0,34,0,0,0,48,11,66.1,2.203333333
Zach Trotman,PIT,D,5,0,0,0,1,6,0,0,0,14,7,13.4,2.68
Zach Werenski,CLS,D,35,13,12,25,3,92,3,6,9,25,36,140.8,4.022857143
Zachary Senyshyn,BOS,RW,4,0,2,2,1,1,0,0,0,2,1,6.4,1.6
Zack Kassian,EDM,RW,41,13,15,28,5,69,0,0,0,115,7,160.1,3.904878049
Zack MacEwen,VAN,C,8,1,1,2,3,3,0,0,0,21,2,19.2,2.4
Zack Smith,CHI,C,36,2,6,8,-1,30,0,0,0,83,15,78.5,2.180555556
Zdeno Chara,BOS,D,42,5,8,13,17,56,0,0,0,49,67,119.9,2.854761905
Zemgus Girgensons,BUF,C,43,6,4,10,1,53,0,0,0,65,11,85.7,1.993023256