Player,Team,Pos,Games,G,A,Pts,plusminus,SOG,PPG,PPA,PPP,Hits,BS,FP,FPGP
A.J. Greer,COL,LW,15,1,1,2,-2,9,0,0,0,20,5,20.1,1.34
Aaron Ekblad,FLA,D,82,13,24,37,1,180,5,5,10,114,88,270.5,3.298780488
Adam Clendening,CLS,D,4,0,0,0,1,3,0,0,0,1,3,3.7,0.925
Adam Cracknell,FA,C,2,0,0,0,-1,3,0,0,0,6,0,3.7,1.85
Adam Erne,DET,LW,65,7,13,20,10,70,2,0,2,159,26,174.5,2.684615385
Adam Gaudette,VAN,C,56,5,7,12,-8,55,0,2,2,48,15,80.5,1.4375
Adam Henrique,ANH,C,82,18,24,42,-5,122,8,5,13,78,71,235.8,2.875609756
Adam Johnson,PIT,C,6,0,2,2,2,3,0,0,0,11,3,13.2,2.2
Adam Larsson,EDM,D,82,3,17,20,-28,117,0,0,0,256,128,267.8,3.265853659
Adam Lowry,WPG,LW,78,12,11,23,6,105,0,0,0,223,49,239,3.064102564
Adam McQuaid,FA,D,50,3,4,7,2,28,0,0,0,122,88,134.2,2.684
Adam Pelech,NYI,D,78,5,16,21,22,110,0,0,0,149,116,234.5,3.006410256
Adrian Kempe,LA,C,81,12,16,28,-10,118,0,4,4,86,21,167.7,2.07037037
Alan Quine,CGY,C,13,3,2,5,0,11,1,0,1,14,2,26.4,2.030769231
Alec Martinez,LA,D,60,4,14,18,-2,78,0,2,2,78,135,178.7,2.978333333
Aleksander Barkov,FLA,C,82,35,61,96,-3,206,13,18,31,28,61,383.4,4.675609756
Alex Biega,DET,D,41,2,14,16,0,91,0,1,1,101,43,143.4,3.497560976
Alex Chiasson,EDM,RW,73,22,16,38,-1,123,8,7,15,85,31,219.7,3.009589041
Alex DeBrincat,CHI,RW,82,41,35,76,0,220,13,11,24,35,26,335.5,4.091463415
Alex Formenton,OTT,LW,9,1,0,1,-2,16,0,0,0,11,7,17.4,1.933333333
Alex Galchenyuk,PIT,RW,72,19,22,41,-19,159,9,12,21,62,34,224.1,3.1125
Alex Goligoski,ARI,D,76,3,24,27,-7,102,1,6,7,79,154,217.8,2.865789474
Alex Iafallo,LA,C,82,15,18,33,-17,148,2,4,6,87,54,208.2,2.53902439
Alex Kerfoot,TOR,C,78,15,27,42,-9,116,4,12,16,22,29,182.4,2.338461538
Alex Killorn,TB,C,82,18,22,40,22,153,2,3,5,88,23,230.7,2.813414634
Alex Ovechkin,WAS,LW,81,51,38,89,7,338,18,10,28,223,41,527.7,6.514814815
Alex Petrovic,BOS,D,35,0,2,2,-15,47,0,0,0,116,53,99.8,2.851428571
Alex Pietrangelo,STL,D,71,13,28,41,2,168,3,12,15,62,139,278.7,3.925352113
Alex Tuch,VGK,RW,74,20,32,52,13,180,3,3,6,92,40,274.5,3.709459459
Alexander Edler,VAN,D,56,10,24,34,3,128,4,13,17,127,166,294.2,5.253571429
Alexander Nylander,CHI,RW,12,2,2,4,-4,16,1,0,1,1,1,16.4,1.366666667
Alexander Radulov,DAL,RW,70,29,43,72,22,209,7,16,23,60,83,362.1,5.172857143
Alexander Steen,STL,LW,65,10,17,27,2,114,2,3,5,55,50,168.1,2.586153846
Alexander Wennberg,CLS,C,75,2,23,25,-1,64,1,5,6,34,32,116.1,1.548
Alexandre Fortin,CHI,C,24,3,3,6,-6,29,0,0,0,21,7,37.6,1.566666667
Alexandre Texier,CLS,C,2,1,0,1,3,6,0,0,0,2,1,8.4,4.2
Anders Bjork,BOS,LW,20,1,2,3,-1,18,0,0,0,9,12,24.2,1.21
Anders Lee,NYI,C,82,28,23,51,20,204,10,6,16,103,51,314.6,3.836585366
Andre Burakovsky,COL,LW,76,12,13,25,2,100,1,0,1,35,29,136,1.789473684
Andreas Athanasiou,DET,C,76,30,24,54,-9,216,3,8,11,33,26,260.4,3.426315789
Andreas Englund,OTT,D,3,0,0,0,-2,2,0,0,0,5,2,3.3,1.1
Andreas Johnsson,TOR,LW,73,20,23,43,14,130,3,3,6,60,36,219,3
Andreas Martinsen,PIT,LW,24,1,3,4,-5,21,0,0,0,83,9,60.9,2.5375
Andrei Svechnikov,CAR,RW,82,20,17,37,0,189,0,5,5,123,26,249.1,3.037804878
Andrej Sekera,DAL,D,24,0,4,4,3,28,0,1,1,17,21,40.7,1.695833333
Andrej Sustr,FA,D,5,0,0,0,0,6,0,0,0,3,7,7.4,1.48
Andrew Agozzino,PIT,LW,11,1,1,2,2,11,0,0,0,14,3,18.9,1.718181818
Andrew Cogliano,DAL,LW,78,6,11,17,1,106,1,0,1,68,32,133.9,1.716666667
Andrew Copp,WPG,C,69,11,14,25,20,82,0,0,0,71,34,156.3,2.265217391
Andrew Ladd,NYI,LW,26,3,8,11,3,34,0,0,0,37,8,62.6,2.407692308
Andrew MacDonald,FA,D,47,0,9,9,-5,41,0,0,0,30,95,94.4,2.008510638
Andrew Mangiapane,CGY,LW,44,8,5,13,11,65,0,0,0,43,17,95.5,2.170454545
Andrew Shaw,CHI,C,63,19,28,47,17,135,3,3,6,128,36,263.5,4.182539683
Andy Greene,NJ,D,82,5,20,25,-9,104,0,2,2,67,208,231.6,2.824390244
Andy Welinski,PHI,D,26,1,3,4,-5,32,0,0,0,47,18,51.8,1.992307692
Anthony Beauvillier,NYI,LW,81,18,10,28,1,156,1,1,2,87,35,199.9,2.467901235
Anthony Bitetto,WPG,D,36,0,3,3,-7,30,0,0,0,80,36,72.5,2.013888889
Anthony Cirelli,TB,C,82,19,20,39,25,123,0,1,1,94,49,231.2,2.819512195
Anthony DeAngelo,NYR,D,61,4,26,30,6,111,0,10,10,54,82,189.4,3.104918033
Anthony Duclair,OTT,LW,74,19,14,33,-2,132,7,1,8,32,33,177.3,2.395945946
Anthony Greco,FLA,C,1,0,0,0,-3,2,0,0,0,0,0,-0.7,-0.7
Anthony Mantha,DET,RW,67,25,23,48,-8,198,7,6,13,67,23,254.2,3.794029851
Anthony Peluso,EDM,RW,4,0,0,0,-1,1,0,0,0,4,0,1.9,0.475
Anthony Richard,NSH,C,1,0,0,0,-1,0,0,0,0,0,1,0,0
Antoine Roussel,VAN,LW,65,9,22,31,5,84,0,0,0,87,50,175.6,2.701538462
Anton Blidh,BOS,LW,1,0,0,0,0,0,0,0,0,6,1,3.5,3.5
Anton Lindholm,COL,D,2,0,0,0,-1,0,0,0,0,1,1,0.5,0.25
Anton Stralman,FLA,D,47,2,15,17,12,57,0,1,1,59,71,130.8,2.782978723
Antti Suomela,SJ,C,27,3,5,8,1,42,0,0,0,10,11,46.8,1.733333333
Anze Kopitar,LA,C,81,22,38,60,-20,156,1,18,19,59,66,275.9,3.40617284
Artem Anisimov,OTT,C,78,15,22,37,-2,142,1,3,4,25,33,177.8,2.279487179
Artemi Panarin,NYR,LW,79,28,59,87,14,191,6,12,18,14,17,318.9,4.036708861
Artturi Lehkonen,MON,LW,82,11,20,31,10,176,0,0,0,120,39,227.9,2.779268293
Ashton Sautner,VAN,D,17,0,1,1,-2,21,0,0,0,25,17,30.4,1.788235294
Austin Czarnik,CGY,C,54,6,12,18,-1,65,0,3,3,10,24,87.5,1.62037037
Austin Wagner,LA,LW,62,12,9,21,2,67,0,0,0,142,9,157.3,2.537096774
Austin Watson,NSH,LW,37,7,9,16,11,64,1,0,1,109,28,139.6,3.772972973
Auston Matthews,TOR,C,68,37,36,73,-9,251,12,8,20,28,60,342.9,5.042647059
Barclay Goodrow,SJ,LW,82,7,10,17,4,84,0,0,0,125,68,173.1,2.11097561
Ben Chiarot,MON,D,78,5,15,20,6,111,0,0,0,171,139,247.4,3.171794872
Ben Harpur,TOR,D,51,1,4,5,-13,50,0,0,0,89,69,103.5,2.029411765
Ben Hutton,LA,D,69,5,15,20,-23,114,1,7,8,55,102,165.6,2.4
Ben Lovejoy,FA,D,71,2,7,9,-1,95,0,0,0,76,118,154.5,2.176056338
Ben Street,NJ,C,21,3,2,5,-4,19,0,0,0,19,9,32.6,1.552380952
Benjamin Gleason,DAL,D,4,0,1,1,-1,2,0,0,0,2,1,3.8,0.95
Blake Coleman,NJ,C,78,22,14,36,-19,213,3,0,3,225,44,307.2,3.938461538
Blake Comeau,DAL,LW,77,7,11,18,-7,102,0,0,0,208,40,204.3,2.653246753
Blake Lizotte,LA,LW,1,0,0,0,-1,1,0,0,0,0,1,0.4,0.4
Blake Pietila,ANH,LW,19,0,1,1,-7,22,0,0,0,36,8,29.3,1.542105263
Blake Wheeler,WPG,RW,82,20,71,91,0,231,2,31,33,81,53,394.4,4.809756098
Bo Horvat,VAN,C,82,27,34,61,-4,227,7,11,18,62,63,318.3,3.881707317
Bobby Ryan,OTT,RW,78,15,27,42,-29,160,7,9,16,77,49,227.5,2.916666667
Bogdan Kiselevich,FA,D,32,0,8,8,-3,14,0,0,0,49,21,55.1,1.721875
Boo Nieves,NYR,C,43,4,6,10,-4,34,0,0,0,33,18,61.1,1.420930233
Boone Jenner,CLS,LW,77,16,22,38,6,170,1,2,3,158,70,280,3.636363636
Brad Hunt,MIN,D,42,5,7,12,-2,75,4,4,8,18,28,89,2.119047619
Brad Malone,EDM,C,16,0,0,0,0,13,0,0,0,35,5,25.2,1.575
Brad Marchand,BOS,LW,79,36,64,100,15,231,10,24,34,46,19,402.4,5.093670886
Brad Richardson,ARI,C,66,19,8,27,6,128,0,0,0,63,55,186.2,2.821212121
Brady Keeper,FLA,D,1,0,0,0,1,1,0,0,0,2,1,2.4,2.4
Brady Skjei,NYR,D,78,8,17,25,-4,126,0,0,0,178,119,254.9,3.267948718
Brady Tkachuk,OTT,LW,71,22,23,45,-10,214,4,6,10,174,26,302.6,4.261971831
Brandon Carlo,BOS,D,72,2,8,10,22,116,0,0,0,134,88,190.4,2.644444444
Brandon Davidson,CGY,D,10,0,1,1,-4,7,0,0,0,17,15,18.8,1.88
Brandon Dubinsky,CLS,C,61,6,8,14,-16,63,0,0,0,147,28,138.7,2.273770492
Brandon Gignac,NJ,C,1,0,0,0,-2,1,0,0,0,0,1,-0.1,-0.1
Brandon Manning,EDM,D,39,2,2,4,-15,33,0,0,0,63,40,67.2,1.723076923
Brandon Montour,BUF,D,82,8,27,35,-20,181,1,5,6,99,121,256.4,3.126829268
Brandon Pirri,VGK,C,31,12,6,18,7,82,3,1,4,29,13,109.3,3.525806452
Brandon Saad,CHI,LW,80,23,24,47,-9,195,5,1,6,52,25,235,2.9375
Brandon Sutter,VAN,C,26,4,2,6,-12,43,1,0,1,33,13,51.2,1.969230769
Brandon Tanev,PIT,LW,80,14,15,29,9,127,0,0,0,278,81,306.8,3.835
Brayden McNabb,VGK,D,81,4,12,16,11,84,0,0,0,200,139,244.6,3.019753086
Brayden Point,TB,C,79,41,51,92,27,191,20,15,35,31,43,386.9,4.897468354
Brayden Schenn,STL,C,72,17,37,54,3,159,4,8,12,111,31,273.1,3.793055556
Braydon Coburn,TB,D,74,4,19,23,4,113,0,0,0,96,62,176.2,2.381081081
Brendan Gallagher,MON,RW,82,33,19,52,10,302,4,3,7,126,31,348.3,4.247560976
Brendan Gaunce,BOS,C,3,1,2,3,3,2,0,0,0,4,0,11.3,3.766666667
Brendan Guhle,ANH,D,8,0,1,1,-2,15,0,0,0,9,7,15,1.875
Brendan Leipsic,WAS,LW,62,7,16,23,-14,92,1,3,4,56,28,128.8,2.077419355
Brendan Lemieux,NYR,LW,63,12,5,17,6,67,0,0,0,129,31,155.8,2.473015873
Brendan Perlini,DET,LW,68,14,7,21,-17,117,2,2,4,51,22,134.8,1.982352941
Brendan Smith,NYR,D,63,4,9,13,-7,66,0,0,0,100,48,126.9,2.014285714
Brenden Dillon,SJ,D,82,1,21,22,19,71,0,0,0,202,78,222.9,2.718292683
Brent Burns,SJ,D,82,16,67,83,13,300,7,21,28,90,105,434,5.292682927
Brent Seabrook,CHI,D,78,5,23,28,-6,165,2,8,10,124,180,286,3.666666667
Brett Connolly,FLA,RW,81,22,24,46,13,139,1,1,2,53,25,217.1,2.680246914
Brett Howden,NYR,C,66,6,17,23,-16,74,0,2,2,64,47,131.1,1.986363636
Brett Kulak,MON,D,57,6,11,17,12,102,0,0,0,107,64,172.3,3.022807018
Brett Pesce,CAR,D,73,7,22,29,35,98,0,0,0,53,131,213.7,2.92739726
Brett Ritchie,BOS,RW,53,4,2,6,-7,57,1,0,1,126,13,105.8,1.996226415
Brett Seney,NJ,LW,51,5,8,13,-14,49,0,1,1,48,15,76.1,1.492156863
Brian Boyle,FLA,C,73,18,6,24,-14,123,7,2,9,145,50,214.7,2.94109589
Brian Dumoulin,PIT,D,76,3,20,23,31,99,0,0,0,141,129,239.1,3.146052632
Brian Gibbons,CAR,C,64,8,11,19,-5,50,0,0,0,40,29,98,1.53125
Brian Lashoff,DET,D,4,0,1,1,-1,2,0,0,0,3,4,5.8,1.45
Brock Boeser,VAN,RW,69,26,30,56,-2,209,6,9,15,14,22,253.6,3.675362319
Brock McGinn,CAR,LW,82,10,16,26,10,123,0,0,0,137,38,203.7,2.484146341
Brock Nelson,NYI,C,82,25,28,53,20,181,2,6,8,51,55,274.4,3.346341463
Brogan Rafferty,VAN,D,2,0,0,0,-1,3,0,0,0,0,2,1.7,0.85
Brooks Orpik,FA,D,53,2,7,9,8,43,0,0,0,131,78,145.7,2.749056604
Bryan Little,WPG,C,82,15,26,41,-12,126,4,3,7,62,29,193.9,2.364634146
Bryan Rust,PIT,RW,72,18,17,35,10,141,0,0,0,119,59,238.4,3.311111111
C.J. Smith,BUF,LW,11,2,0,2,0,18,0,0,0,4,1,15.7,1.427272727
Cal Clutterbuck,NYI,RW,73,8,15,23,6,95,3,0,3,209,40,222.5,3.047945205
Caleb Jones,EDM,D,17,1,5,6,-9,21,0,1,1,20,18,36.9,2.170588235
Calle Jarnkrok,NSH,C,79,10,16,26,13,106,1,1,2,56,22,151.9,1.92278481
Calle Rosen,COL,D,4,1,0,1,-3,5,0,0,0,1,2,5,1.25
Calvin de Haan,CHI,D,74,1,13,14,1,102,0,0,0,187,106,216.8,2.92972973
Cam Atkinson,CLS,RW,80,41,28,69,3,295,8,6,14,27,25,338.5,4.23125
Cam Fowler,ANH,D,59,5,18,23,-14,88,1,5,6,32,91,146.7,2.486440678
Cameron Gaunce,TB,D,2,0,0,0,3,2,0,0,0,4,1,4.8,2.4
Cameron Schilling,WPG,D,4,0,1,1,0,2,0,0,0,3,5,6.8,1.7
Carl Dahlstrom,WPG,D,38,0,6,6,9,42,0,0,0,33,35,67.3,1.771052632
Carl Grundstrom,LA,LW,15,5,1,6,-4,26,0,1,1,38,3,46.9,3.126666667
Carl Gunnarsson,STL,D,25,3,4,7,8,21,0,0,0,11,35,52.4,2.096
Carl Hagelin,WAS,LW,58,5,14,19,7,99,0,0,0,64,20,128.1,2.20862069
Carl Soderberg,ARI,C,82,23,26,49,-5,188,2,8,10,99,67,286.7,3.496341463
Carter Rowney,ANH,C,62,7,13,20,0,53,0,0,0,178,35,174.7,2.817741935
Casey Cizikas,NYI,C,73,20,13,33,22,111,0,0,0,129,68,239.9,3.28630137
Casey Mittelstadt,BUF,C,77,12,13,25,-19,118,3,7,10,30,16,132.7,1.723376623
Casey Nelson,BUF,D,38,1,5,6,1,37,0,0,0,44,36,68.3,1.797368421
Cedric Paquette,TB,C,80,13,4,17,7,87,0,0,0,269,61,250.3,3.12875
Chad Ruhwedel,PIT,D,18,1,1,2,-9,22,0,0,0,40,16,37.3,2.072222222
Chandler Stephenson,VGK,RW,64,5,6,11,-13,36,0,0,0,38,33,70.4,1.1
Charles Hudon,MON,LW,32,3,2,5,-9,50,0,1,1,73,9,70.5,2.203125
Charlie Coyle,BOS,C,81,12,22,34,-1,155,1,3,4,77,56,212,2.617283951
Charlie McAvoy,BOS,D,54,7,21,28,14,79,1,1,2,92,91,195.1,3.612962963
Chase De Leo,ANH,C,1,0,0,0,1,4,0,0,0,1,0,2.6,2.6
Chris Butler,FA,D,13,1,1,2,3,10,0,0,0,17,17,27.5,2.115384615
Chris Kreider,NYR,LW,79,28,24,52,4,201,7,5,12,159,49,330.4,4.182278481
Chris Kunitz,FA,LW,56,5,5,10,-7,44,0,0,0,85,15,89.1,1.591071429
Chris Tanev,VAN,D,55,2,10,12,3,51,0,0,0,29,122,123.4,2.243636364
Chris Thorburn,FA,RW,1,0,0,0,0,0,0,0,0,1,0,0.5,0.5
Chris Tierney,OTT,C,81,9,39,48,-22,116,0,10,10,30,54,192.4,2.375308642
Chris Wagner,BOS,RW,76,12,7,19,3,135,0,0,0,247,38,248,3.263157895
Chris Wideman,ANH,D,25,2,5,7,-12,27,0,1,1,35,26,52.3,2.092
Christian Djoos,WAS,D,45,1,9,10,9,33,0,0,0,18,28,61.7,1.371111111
Christian Dvorak,ARI,LW,20,2,5,7,-2,25,1,0,1,16,7,37.5,1.875
Christian Fischer,ARI,RW,71,11,7,18,-13,116,0,0,0,124,19,158.4,2.230985915
Christian Folin,MON,D,45,0,6,6,6,47,0,0,0,125,78,135.3,3.006666667
Christian Jaros,OTT,D,61,1,9,10,-14,65,0,2,2,110,82,138,2.262295082
Christian Wolanin,OTT,D,30,4,8,12,3,36,0,3,3,11,31,67.9,2.263333333
Christoffer Ehn,DET,C,60,3,6,9,-5,49,0,0,0,70,39,92.6,1.543333333
Clark Bishop,CAR,C,20,1,2,3,-3,16,0,0,0,39,5,33.9,1.695
Claude Giroux,PHI,C,82,22,63,85,9,229,2,21,23,28,19,334.6,4.080487805
Clayton Keller,ARI,C,82,14,33,47,-21,200,1,18,19,16,21,215,2.62195122
Cody Ceci,TOR,D,74,7,19,26,-22,132,0,1,1,120,142,232.8,3.145945946
Cody Eakin,VGK,C,78,22,19,41,19,120,1,3,4,88,35,227,2.91025641
Cody Goloubef,OTT,D,5,0,0,0,0,3,0,0,0,13,5,10.2,2.04
Cody McLeod,FA,LW,38,1,0,1,-13,22,0,0,0,112,10,66.3,1.744736842
Colby Cave,EDM,C,53,3,5,8,-5,58,0,0,0,73,18,85.2,1.60754717
Colin Blackwell,NSH,C,6,0,0,0,-1,5,0,0,0,10,3,8,1.333333333
Colin Miller,BUF,D,65,3,26,29,0,131,1,12,13,122,64,219.4,3.375384615
Colin White,OTT,C,71,14,27,41,-24,123,5,3,8,23,35,170.2,2.397183099
Colin Wilson,COL,LW,65,12,15,27,-6,104,5,2,7,55,31,154.6,2.378461538
Colton Parayko,STL,D,80,10,18,28,20,176,4,4,8,127,157,296.4,3.705
Colton Sceviour,FLA,RW,59,5,10,15,-2,116,0,1,1,89,58,154.9,2.625423729
Colton Sissons,NSH,RW,75,15,15,30,20,111,1,1,2,109,52,211.9,2.825333333
Colton White,NJ,D,3,0,0,0,-2,1,0,0,0,2,2,1.4,0.466666667
Connor Brickley,FA,C,14,1,3,4,3,18,0,0,0,35,6,38.2,2.728571429
Connor Brown,OTT,RW,82,8,21,29,11,85,0,1,1,35,37,142.5,1.737804878
Connor Carrick,NJ,D,34,2,9,11,-13,42,0,1,1,25,37,66.3,1.95
Connor Clifton,BOS,D,19,0,1,1,5,22,0,0,0,40,13,39.8,2.094736842
Connor McDavid,EDM,C,78,41,75,116,3,240,9,24,33,39,30,438,5.615384615
Connor Murphy,CHI,D,52,5,8,13,12,84,0,0,0,119,91,175.6,3.376923077
Conor Garland,ARI,RW,47,13,5,18,1,118,4,2,6,33,17,127.7,2.717021277
Conor Sheary,BUF,LW,78,14,20,34,-18,147,4,2,6,29,29,166.8,2.138461538
Cooper Marody,EDM,C,6,0,0,0,-1,6,0,0,0,0,0,1.9,0.316666667
Corban Knight,FA,C,23,1,3,4,-5,15,0,0,0,9,13,23.5,1.02173913
Corey Perry,DAL,RW,31,6,4,10,-16,59,2,2,4,21,14,63.1,2.035483871
Cory Conacher,TB,LW,1,0,0,0,0,1,0,0,0,0,0,0.4,0.4
Craig Smith,NSH,RW,76,21,17,38,11,205,4,4,8,77,33,247.5,3.256578947
Curtis Lazar,BUF,C,1,0,0,0,-1,0,0,0,0,0,1,0,0
Dakota Mermis,NJ,D,1,0,0,0,1,0,0,0,0,0,0,0.5,0.5
Dale Weise,MON,RW,51,5,6,11,-8,58,0,0,0,88,21,100.7,1.974509804
Dalton Prout,SJ,D,20,1,1,2,1,14,0,0,0,36,20,39.1,1.955
Damon Severson,NJ,D,82,11,28,39,-27,146,3,9,12,83,87,230.9,2.815853659
Dan Girardi,FA,D,62,4,12,16,6,75,0,0,0,151,108,198.5,3.201612903
Dan Hamhuis,NSH,D,57,0,5,5,-2,39,0,0,0,38,61,74.1,1.3
Danick Martel,TB,C,9,0,2,2,3,16,0,0,0,12,1,18.4,2.044444444
Daniel Brickley,LA,D,4,0,1,1,-2,2,0,0,0,5,4,6.3,1.575
Daniel Carr,NSH,LW,6,1,0,1,-1,11,0,0,0,9,3,12.9,2.15
Daniel Sprong,ANH,RW,63,14,9,23,-16,125,2,3,5,35,14,131.5,2.087301587
Danny DeKeyser,DET,D,52,5,15,20,2,59,0,0,0,79,94,156.1,3.001923077
Danny O'Regan,NYR,C,1,0,0,0,0,2,0,0,0,0,0,0.8,0.8
Dante Fabbro,NSH,D,4,1,0,1,-1,5,0,0,0,3,6,9,2.25
Danton Heinen,BOS,C,77,11,23,34,13,114,1,6,7,54,36,183.1,2.377922078
Darnell Nurse,EDM,D,82,10,31,41,-5,196,1,8,9,162,146,330.9,4.035365854
Darren Archibald,TOR,RW,12,1,1,2,-3,10,0,0,0,10,4,14.5,1.208333333
Darren Helm,DET,C,61,7,10,17,-11,107,0,0,0,50,26,116.3,1.906557377
David Backes,BOS,RW,70,7,13,20,0,129,2,5,7,140,30,190.6,2.722857143
David Kampf,CHI,RW,63,4,15,19,-6,72,0,0,0,39,30,102.3,1.623809524
David Krejci,BOS,C,81,20,53,73,7,139,6,10,16,28,24,267.1,3.297530864
David Pastrnak,BOS,RW,66,38,43,81,6,235,17,16,33,57,25,371,5.621212121
David Perron,STL,RW,57,23,23,46,3,112,7,7,14,52,13,207.8,3.645614035
David Savard,CLS,D,82,8,16,24,19,124,0,0,0,122,123,237.6,2.897560976
David Schlemko,FA,D,18,0,2,2,-1,29,0,2,2,29,45,54.1,3.005555556
Dean Kukan,CLS,D,25,0,5,5,6,16,0,0,0,16,21,37.9,1.516
Denis Gurianov,DAL,RW,21,1,3,4,-3,23,0,1,1,23,9,33.7,1.604761905
Denis Malgin,FLA,C,50,7,9,16,-10,66,0,1,1,40,21,91.9,1.838
Dennis Cholowski,DET,D,52,7,9,16,-20,71,4,5,9,18,50,100.4,1.930769231
Dennis Gilbert,CHI,D,1,0,0,0,0,0,0,0,0,6,1,3.5,3.5
Derek Forbort,LA,D,81,2,12,14,-13,75,0,0,0,105,139,175.5,2.166666667
Derek Grant,ANH,C,56,4,10,14,-6,74,0,0,0,92,29,119.1,2.126785714
Derek MacKenzie,FA,C,1,0,0,0,0,0,0,0,0,0,0,0,0
Derek Ryan,CGY,C,81,13,25,38,21,103,2,5,7,19,19,166.7,2.058024691
Derek Stepan,ARI,C,72,15,20,35,-2,195,1,2,3,50,51,215.5,2.993055556
Derick Brassard,NYI,C,70,14,9,23,-19,110,2,3,5,102,15,158,2.257142857
Derrick Pouliot,STL,D,62,3,9,12,-1,58,1,0,1,76,71,124.2,2.003225806
Deryk Engelland,VGK,D,74,2,10,12,-3,105,0,0,0,165,152,225,3.040540541
Devante Smith-Pelly,FA,RW,54,4,4,8,-6,60,0,0,0,78,36,98,1.814814815
Devin Shore,ANH,C,76,10,19,29,-12,82,2,3,5,94,64,178.8,2.352631579
Devon Toews,NYI,D,48,5,13,18,7,81,1,3,4,24,30,107.9,2.247916667
Dillon Dube,CGY,C,25,1,4,5,2,22,0,0,0,11,3,27.8,1.112
Dillon Heatherington,DAL,D,5,0,1,1,4,5,0,0,0,6,2,10,2
Dion Phaneuf,FA,D,67,1,5,6,-21,80,0,0,0,128,79,138,2.059701493
Dmitrij Jaskin,FA,RW,37,2,6,8,-5,48,0,0,0,87,14,85.2,2.302702703
Dmitry Kulikov,WPG,D,57,0,6,6,4,40,0,0,0,88,71,109.5,1.921052632
Dmitry Orlov,WAS,D,82,3,26,29,3,101,0,1,1,137,103,223.9,2.730487805
Dominic Toninato,FLA,LW,2,1,0,1,0,1,0,0,0,0,1,3.9,1.95
Dominic Turgeon,DET,C,4,0,0,0,-3,2,0,0,0,3,3,2.3,0.575
Dominik Kahun,PIT,C,82,13,24,37,10,137,1,1,2,13,27,168.8,2.058536585
Dominik Simon,PIT,C,71,8,20,28,8,121,1,2,3,89,19,173.4,2.442253521
Dougie Hamilton,CAR,D,82,18,21,39,0,259,2,5,7,160,91,332.1,4.05
Drake Batherson,OTT,RW,20,3,6,9,-2,18,2,1,3,17,21,49.2,2.46
Drake Caggiula,CHI,LW,55,12,11,23,-5,96,0,0,0,135,26,174.4,3.170909091
Drew Doughty,LA,D,82,8,37,45,-34,154,7,17,24,168,120,310.6,3.787804878
Drew Stafford,FA,RW,57,5,8,13,-7,77,1,1,2,50,19,94.8,1.663157895
Dryden Hunt,FLA,LW,31,3,7,10,0,53,0,0,0,65,9,81.2,2.619354839
Duncan Keith,CHI,D,82,6,34,40,13,141,0,3,3,42,144,244.9,2.986585366
Dustin Brown,LA,RW,72,22,29,51,-17,180,9,3,12,150,29,289,4.013888889
Dustin Byfuglien,WPG,D,42,4,27,31,4,115,1,15,16,77,51,194,4.619047619
Dylan DeMelo,OTT,D,77,4,18,22,-1,109,0,3,3,121,130,219.6,2.851948052
Dylan Gambrell,SJ,C,8,0,0,0,1,6,0,0,0,13,1,9.9,1.2375
Dylan Larkin,DET,C,76,32,41,73,-6,287,7,8,15,80,38,363.8,4.786842105
Dylan McIlrath,DET,D,7,0,0,0,2,6,0,0,0,19,7,16.4,2.342857143
Dylan Sikura,CHI,LW,33,0,8,8,2,52,0,0,0,3,10,44.3,1.342424242
Dylan Strome,CHI,C,78,20,37,57,-8,145,6,10,16,13,46,233.5,2.993589744
Eeli Tolvanen,NSH,LW,4,1,1,2,2,2,0,1,1,4,2,10.8,2.7
Egor Yakovlev,FA,D,25,2,5,7,-6,24,0,0,0,12,22,39.6,1.584
Elias Lindholm,CGY,RW,81,27,51,78,30,182,9,17,26,82,39,357.3,4.411111111
Elias Pettersson,VAN,C,71,28,38,66,3,144,10,12,22,42,51,287.6,4.050704225
Eric Fehr,FA,RW,72,7,8,15,-8,67,0,0,0,40,48,103.8,1.441666667
Eric Gryba,FA,D,10,0,0,0,-1,11,0,0,0,21,16,22.4,2.24
Eric Robinson,CLS,LW,13,0,0,0,-4,18,0,0,0,24,1,17.7,1.361538462
Eric Staal,MIN,C,81,22,30,52,-7,215,7,8,15,41,28,258,3.185185185
Eric Tangradi,FA,LW,6,0,1,1,-3,10,0,0,0,11,4,12,2
Erik Brannstrom,OTT,D,2,0,0,0,0,0,0,0,0,1,1,1,0.5
Erik Burgdoerfer,WAS,D,4,0,0,0,-1,2,0,0,0,16,0,8.3,2.075
Erik Cernak,TB,D,58,5,11,16,25,107,1,0,1,198,79,231.8,3.996551724
Erik Condra,COL,RW,6,1,0,1,-2,10,0,0,0,3,1,8,1.333333333
Erik Gudbranson,ANH,D,76,2,8,10,-20,94,0,0,0,184,84,183.6,2.415789474
Erik Gustafsson,CHI,D,79,17,43,60,-6,160,4,14,18,100,115,323.5,4.094936709
Erik Haula,CAR,C,15,2,5,7,1,26,0,1,1,11,6,36.4,2.426666667
Erik Johnson,COL,D,80,7,18,25,8,144,0,0,0,124,143,252.1,3.15125
Erik Karlsson,SJ,D,53,3,42,45,6,169,2,18,20,44,69,240.1,4.530188679
Esa Lindell,DAL,D,82,11,21,32,14,132,4,3,7,143,161,293.8,3.582926829
Evan Bouchard,EDM,D,7,1,0,1,-5,10,1,0,1,6,8,12.5,1.785714286
Evan Rodrigues,BUF,C,74,9,20,29,-7,168,2,2,4,33,33,167.7,2.266216216
Evander Kane,SJ,LW,75,30,26,56,-4,268,5,6,11,173,25,357.2,4.762666667
Evgeni Malkin,PIT,C,68,21,51,72,-25,187,9,17,26,54,33,296.8,4.364705882
Evgenii Dadonov,FLA,RW,82,28,42,70,-6,195,8,9,17,33,42,297.5,3.62804878
Evgeny Kuznetsov,WAS,C,76,21,51,72,7,193,8,15,23,46,20,301.7,3.969736842
Filip Chlapik,OTT,C,5,1,0,1,-2,9,0,0,0,1,4,8.1,1.62
Filip Chytil,NYR,C,75,11,12,23,-22,133,3,4,7,29,21,131.2,1.749333333
Filip Forsberg,NSH,RW,64,28,22,50,8,217,7,3,10,100,29,293.3,4.5828125
Filip Hronek,DET,D,46,5,18,23,-10,73,1,4,5,66,32,129.2,2.808695652
Filip Zadina,DET,LW,9,1,2,3,-5,18,1,1,2,6,3,18.2,2.022222222
Frank Vatrano,FLA,LW,81,24,15,39,-10,208,2,6,8,139,74,294.7,3.638271605
Frans Nielsen,DET,C,72,10,25,35,-7,120,0,8,8,79,44,194,2.694444444
Frederick Gaudreau,NSH,C,55,3,1,4,1,43,0,0,0,25,18,50.2,0.912727273
Frederik Gauthier,TOR,C,70,3,11,14,3,46,0,0,0,98,28,113.9,1.627142857
Fredrik Claesson,CAR,D,37,2,4,6,3,44,0,0,0,76,33,87.6,2.367567568
Gabriel Bourque,WPG,LW,55,2,6,8,3,34,0,0,0,100,48,107.1,1.947272727
Gabriel Carlsson,CLS,D,1,0,0,0,-1,1,0,0,0,0,0,-0.1,-0.1
Gabriel Landeskog,COL,LW,73,34,41,75,17,243,10,17,27,120,64,408.7,5.598630137
Garnet Hathaway,WAS,RW,76,11,8,19,14,77,0,0,0,200,36,204.8,2.694736842
Garrett Wilson,TOR,LW,50,2,6,8,2,54,0,0,0,114,16,105.6,2.112
Gavin Bayreuther,DAL,D,19,2,3,5,2,25,0,2,2,11,19,40,2.105263158
Gemel Smith,TB,C,17,2,1,3,-4,14,0,0,0,13,3,19.6,1.152941176
Greg McKegg,NYR,C,41,6,5,11,-2,27,0,0,0,30,18,61.8,1.507317073
Greg Pateryn,MIN,D,80,1,6,7,-11,100,0,0,0,144,118,180.5,2.25625
Guillaume Brisebois,VAN,D,8,0,0,0,-4,5,0,0,0,3,7,5,0.625
Gustav Forsling,CAR,D,43,3,6,9,-9,57,0,0,0,38,38,77.3,1.797674419
Gustav Nyquist,CLS,RW,81,22,38,60,1,204,2,10,12,36,23,265.6,3.279012346
Hampus Lindholm,ANH,D,76,6,22,28,-5,125,1,5,6,81,133,222.5,2.927631579
Haydn Fleury,CAR,D,20,0,1,1,4,17,0,0,0,25,21,33.8,1.69
Henri Jokiharju,BUF,D,38,0,12,12,-7,62,0,1,1,48,37,88.8,2.336842105
Henrik Borgstrom,FLA,C,50,8,10,18,-14,54,3,4,7,11,12,77.1,1.542
Ian Cole,COL,D,71,2,13,15,-1,82,0,0,0,107,178,206.8,2.912676056
Ian McCoshen,CHI,D,19,1,1,2,-2,15,0,0,0,41,13,37,1.947368421
Igor Ozhiganov,FA,D,53,3,4,7,0,43,0,0,0,57,48,86.7,1.635849057
Ilya Kovalchuk,MON,RW,64,16,18,34,-26,141,4,5,9,28,19,159.9,2.4984375
Ilya Lyubushkin,ARI,D,41,0,4,4,-9,27,0,0,0,150,61,119.8,2.92195122
Isac Lundestrom,ANH,LW,15,0,2,2,-1,13,0,0,0,4,5,13.2,0.88
Ivan Barbashev,STL,LW,80,14,12,26,-4,60,0,0,0,86,31,146.5,1.83125
Ivan Provorov,PHI,D,82,7,19,26,-16,145,0,2,2,123,149,247,3.012195122
J.T. Brown,MIN,RW,56,3,5,8,0,56,0,0,0,99,16,98.9,1.766071429
J.T. Compher,COL,C,66,16,16,32,-8,118,4,5,9,33,59,178.2,2.7
J.T. Miller,VAN,C,75,13,34,47,8,108,4,16,20,115,23,243.2,3.242666667
Jaccob Slavin,CAR,D,82,8,23,31,0,146,5,2,7,70,133,236.9,2.88902439
Jack Eichel,BUF,C,77,28,54,82,-11,303,8,18,26,70,51,394.2,5.119480519
Jack Johnson,PIT,D,82,1,12,13,-4,86,1,1,2,233,147,251.4,3.065853659
Jack Rodewald,FLA,RW,6,0,0,0,0,2,0,0,0,8,3,6.3,1.05
Jack Roslovic,WPG,RW,77,9,15,24,-2,74,5,2,7,32,21,119.1,1.546753247
Jacob De La Rose,STL,C,60,3,6,9,-13,55,0,0,0,72,29,87,1.45
Jacob Larsson,ANH,D,49,0,5,5,-4,57,0,0,0,41,59,80.8,1.648979592
Jacob MacDonald,COL,D,2,1,0,1,1,1,0,0,0,1,1,4.9,2.45
Jacob Middleton,SJ,D,3,0,1,1,-1,0,0,0,0,1,2,3,1
Jacob Nilsson,CHI,C,2,0,0,0,-2,0,0,0,0,1,1,0,0
Jacob Trouba,NYR,D,82,8,42,50,8,162,3,15,18,112,171,336.3,4.101219512
Jaden Schwartz,STL,LW,69,11,25,36,-6,183,2,3,5,61,27,202.2,2.930434783
Jake Bean,CAR,D,2,0,0,0,0,1,0,0,0,1,0,0.9,0.45
Jake Chelios,FA,D,5,0,0,0,0,5,0,0,0,7,5,8,1.6
Jake DeBrusk,BOS,LW,68,27,15,42,2,156,8,3,11,45,24,219.9,3.233823529
Jake Dotchin,STL,D,20,0,1,1,-4,7,0,0,0,54,16,37.8,1.89
Jake Gardiner,CAR,D,62,3,27,30,19,78,0,5,5,61,64,171.2,2.761290323
Jake Guentzel,PIT,LW,82,40,36,76,13,227,6,5,11,105,47,376.3,4.58902439
Jake McCabe,BUF,D,59,4,10,14,-4,64,0,0,0,103,99,156.6,2.654237288
Jake Muzzin,TOR,D,80,9,28,37,21,141,1,4,5,172,134,307.9,3.84875
Jake Virtanen,VAN,LW,70,15,10,25,-4,154,2,0,2,154,37,222.1,3.172857143
Jakob Chychrun,ARI,D,53,5,15,20,-12,117,3,5,8,74,77,169.3,3.194339623
Jakob Forsbacka-Karlsson,BOS,C,28,3,6,9,1,21,0,1,1,14,9,42.4,1.514285714
Jakob Silfverberg,ANH,RW,73,24,19,43,-9,163,3,8,11,38,43,222.2,3.043835616
Jakub Jerabek,FA,D,1,0,0,0,-3,1,0,0,0,0,1,-0.6,-0.6
Jakub Voracek,PHI,LW,78,20,46,66,-16,210,4,14,18,17,29,269,3.448717949
Jakub Vrana,WAS,RW,82,24,23,47,20,161,1,3,4,47,32,235.9,2.876829268
Jakub Zboril,BOS,D,2,0,0,0,0,1,0,0,0,3,0,1.9,0.95
James Neal,EDM,RW,63,7,12,19,-5,141,2,4,6,46,19,137.4,2.180952381
James van Riemsdyk,PHI,LW,66,27,21,48,-10,167,8,5,13,34,16,222.8,3.375757576
Jamie Benn,DAL,C,78,27,26,53,14,189,8,3,11,142,71,333.1,4.270512821
Jamie McGinn,FA,LW,19,4,3,7,-5,23,1,0,1,34,3,44.2,2.326315789
Jamie Oleksiak,DAL,D,57,4,8,12,5,55,0,0,0,135,59,149.5,2.622807018
Jan Rutta,TB,D,37,2,6,8,4,42,0,0,0,24,30,63.8,1.724324324
Janne Kuokkanen,CAR,LW,7,0,0,0,-2,6,0,0,0,0,3,2.9,0.414285714
Jared McCann,PIT,C,78,19,16,35,-1,150,1,2,3,77,51,215.5,2.762820513
Jared Spurgeon,MIN,D,82,14,29,43,-1,152,4,7,11,91,145,289.3,3.52804878
Jaret Anderson-Dolan,LA,C,5,0,1,1,-2,6,0,0,0,5,2,6.9,1.38
Jason Demers,ARI,D,35,2,6,8,9,39,0,1,1,50,43,85.6,2.445714286
Jason Dickinson,DAL,C,67,6,16,22,9,94,0,0,0,106,50,170.1,2.53880597
Jason Garrison,FA,D,17,1,0,1,1,16,1,0,1,13,23,28.9,1.7
Jason Pominville,FA,RW,73,16,15,31,-4,134,1,1,2,18,20,150.6,2.063013699
Jason Spezza,TOR,C,76,8,19,27,-13,121,2,10,12,16,30,138.9,1.827631579
Jason Zucker,MIN,LW,81,21,21,42,-9,214,7,7,14,87,38,262.6,3.241975309
Jay Beagle,VAN,C,57,3,10,13,-8,45,0,0,0,102,33,110.5,1.938596491
Jay Bouwmeester,STL,D,78,3,14,17,-3,82,0,0,0,61,127,162.3,2.080769231
Jayce Hawryluk,FLA,C,42,7,5,12,-8,35,0,1,1,101,25,105,2.5
Jaycob Megna,VGK,D,28,1,3,4,-1,31,0,0,0,32,29,51.4,1.835714286
Jean-Gabriel Pageau,OTT,C,39,4,8,12,-12,83,0,0,0,63,38,105.7,2.71025641
Jean-Sebastien Dea,BUF,C,23,4,2,6,0,29,0,0,0,21,12,44.1,1.917391304
Jeff Carter,LA,C,76,13,20,33,-20,174,5,8,13,80,30,206.6,2.718421053
Jeff Petry,MON,D,82,13,33,46,-5,172,3,8,11,190,123,338.8,4.131707317
Jeff Skinner,BUF,LW,82,40,23,63,0,268,8,8,16,31,24,316.7,3.862195122
Jeremy Lauzon,BOS,D,16,1,0,1,-1,11,0,0,0,15,15,21.9,1.36875
Jesper Bratt,NJ,LW,51,8,25,33,-8,91,1,7,8,36,22,143.4,2.811764706
Jesper Fast,NYR,RW,66,8,12,20,-3,80,0,0,0,120,47,162,2.454545455
Jesperi Kotkaniemi,MON,C,79,11,23,34,1,134,1,4,5,66,41,191.6,2.425316456
Jesse Puljujarvi,FA,RW,46,4,5,9,-14,53,0,1,1,46,26,73.2,1.591304348
Jimmy Schuldt,VGK,D,1,0,1,1,-1,1,0,0,0,0,1,2.4,2.4
Jimmy Vesey,BUF,LW,81,17,18,35,-6,154,1,3,4,79,34,206.1,2.544444444
Joakim Nordstrom,BOS,C,70,7,5,12,0,103,0,0,0,86,52,141.2,2.017142857
Joakim Ryan,LA,D,44,0,7,7,-1,35,0,0,0,43,39,68.5,1.556818182
Joe Hicketts,DET,D,11,0,0,0,-9,16,0,0,0,17,27,23.9,2.172727273
Joe Morrow,FA,D,41,1,6,7,0,40,0,0,0,37,37,68,1.658536585
Joe Pavelski,DAL,RW,75,38,26,64,-4,188,12,9,21,69,61,325.2,4.336
Joe Thornton,SJ,C,73,16,35,51,8,90,3,12,15,17,14,188.5,2.582191781
Joel Armia,MON,RW,57,13,10,23,0,134,2,4,6,113,21,185.6,3.256140351
Joel Edmundson,CAR,D,64,2,9,11,8,102,0,0,0,128,106,185.8,2.903125
Joel Eriksson Ek,MIN,C,58,7,7,14,-7,111,0,0,0,117,24,146.4,2.524137931
Joel Hanley,DAL,D,16,0,0,0,0,9,0,0,0,16,16,19.6,1.225
Joel L'Esperance,DAL,C,18,2,0,2,-4,24,1,0,1,22,4,27.6,1.533333333
Joey Anderson,NJ,RW,34,4,3,7,-7,49,0,0,0,42,11,60.6,1.782352941
Johan Larsson,BUF,C,73,6,8,14,-8,79,0,0,0,112,44,139.6,1.912328767
John Carlson,WAS,D,80,13,57,70,21,185,3,30,33,54,164,379.5,4.74375
John Gilmour,BUF,D,5,0,0,0,-3,9,0,0,0,3,13,10.1,2.02
John Hayden,NJ,C,54,3,2,5,-12,42,0,0,0,97,23,83.8,1.551851852
John Klingberg,DAL,D,64,10,35,45,6,153,5,15,20,42,77,243.7,3.8078125
John Moore,BOS,D,61,4,9,13,0,97,2,1,3,77,76,148.3,2.431147541
John Quenneville,CHI,C,19,1,0,1,-1,16,0,0,0,21,7,22.9,1.205263158
John Tavares,TOR,C,82,47,41,88,19,286,10,9,19,59,53,421.9,5.145121951
Johnny Boychuk,NYI,D,74,3,16,19,10,157,1,2,3,144,120,243.8,3.294594595
Johnny Gaudreau,CGY,LW,82,36,63,99,18,245,6,21,27,12,12,380,4.634146341
Jon Merrill,VGK,D,57,3,12,15,16,72,0,0,0,71,72,141.3,2.478947368
Jonas Brodin,MIN,D,82,4,14,18,-15,111,0,1,1,61,135,175.9,2.145121951
Jonas Siegenthaler,WAS,D,26,0,4,4,6,12,0,0,0,31,44,53.3,2.05
Jonathan Drouin,MON,C,81,18,35,53,-8,190,3,13,16,55,23,251,3.098765432
Jonathan Ericsson,DET,D,52,3,2,5,-10,48,0,0,0,98,56,104.2,2.003846154
Jonathan Huberdeau,FLA,LW,82,30,62,92,-14,226,11,23,34,57,45,382.4,4.663414634
Jonathan Marchessault,VGK,LW,82,25,34,59,2,278,5,11,16,98,22,331.2,4.03902439
Jonathan Toews,CHI,C,82,35,46,81,2,235,9,14,23,42,44,358,4.365853659
Jonny Brodzinski,SJ,RW,13,2,1,3,0,17,0,0,0,23,7,29.8,2.292307692
Joonas Donskoi,COL,RW,80,14,23,37,10,115,1,2,3,36,36,178,2.225
Jordan Eberle,NYI,RW,78,19,18,37,-6,160,7,5,12,36,35,201.5,2.583333333
Jordan Greenway,MIN,LW,81,12,12,24,-12,109,0,0,0,57,40,146.1,1.803703704
Jordan Kyrou,STL,RW,16,1,2,3,-1,16,0,0,0,2,3,15.4,0.9625
Jordan Martinook,CAR,LW,82,15,10,25,1,146,0,0,0,199,46,246.4,3.004878049
Jordan Nolan,STL,RW,14,0,2,2,2,17,0,0,0,22,4,24.8,1.771428571
Jordan Oesterle,ARI,D,71,6,14,20,-3,77,3,4,7,58,139,180.8,2.546478873
Jordan Schmaltz,TOR,D,20,0,2,2,-7,11,0,0,0,10,22,20.9,1.045
Jordan Staal,CAR,C,50,11,17,28,6,121,0,2,2,122,18,190.4,3.808
Jordan Weal,MON,C,63,8,13,21,-8,75,2,4,6,28,26,109,1.73015873
Jordie Benn,VAN,D,81,5,17,22,15,93,0,0,0,124,128,219.7,2.712345679
Jori Lehtera,FA,C,27,1,2,3,-7,17,0,0,0,29,7,28.3,1.048148148
Joseph Blandisi,PIT,C,9,0,0,0,-1,8,0,0,0,10,1,8.2,0.911111111
Joseph Gambardella,EDM,C,15,0,3,3,2,7,0,0,0,14,5,19.3,1.286666667
Josh Anderson,CLS,RW,82,27,20,47,25,230,3,4,7,214,40,359.5,4.384146341
Josh Archibald,EDM,RW,68,12,10,22,1,92,0,0,0,161,39,193.3,2.842647059
Josh Bailey,NYI,LW,82,16,40,56,8,126,2,12,14,19,32,221.9,2.706097561
Josh Brown,FLA,D,37,1,1,2,-3,28,0,0,0,80,31,70.2,1.897297297
Josh Currie,EDM,RW,21,2,3,5,2,19,0,0,0,39,17,48.6,2.314285714
Josh Ho-Sang,NYI,RW,10,1,1,2,2,10,0,0,0,0,3,11.5,1.15
Josh Leivo,VAN,LW,76,14,10,24,5,151,3,4,7,44,23,165.4,2.176315789
Josh Mahura,ANH,D,17,1,4,5,0,20,0,3,3,6,18,34,2
Josh Manson,ANH,D,74,3,13,16,-8,96,0,0,0,184,90,206.4,2.789189189
Josh Morrissey,WPG,D,59,6,25,31,9,95,3,7,10,55,107,201.5,3.415254237
Josh Teves,VAN,D,1,0,0,0,-1,0,0,0,0,4,1,2,2
Joshua Jacobs,NJ,D,1,0,0,0,-1,1,0,0,0,2,1,1.4,1.4
Juho Lammikko,FA,RW,40,0,6,6,-7,39,0,0,0,45,21,57.1,1.4275
Jujhar Khaira,EDM,C,60,3,15,18,-12,64,0,0,0,123,33,136.6,2.276666667
Julius Honka,DAL,D,29,0,4,4,-2,38,0,0,0,16,31,45.7,1.575862069
Justin Abdelkader,DET,LW,71,6,13,19,-14,95,1,1,2,185,34,186.5,2.626760563
Justin Bailey,VAN,RW,11,0,1,1,0,5,0,0,0,9,5,11,1
Justin Braun,PHI,D,78,2,14,16,-14,105,0,1,1,121,120,190.5,2.442307692
Justin Dowling,DAL,C,11,0,1,1,-4,9,0,0,0,11,7,12.6,1.145454545
Justin Falk,FA,D,10,0,0,0,-4,7,0,0,0,36,9,23.3,2.33
Justin Faulk,STL,D,82,11,24,35,9,217,6,4,10,156,121,320.8,3.912195122
Justin Holl,TOR,D,11,0,1,1,-5,6,0,0,0,9,5,8.9,0.809090909
Justin Kloos,ANH,C,1,0,0,0,0,2,0,0,0,2,0,1.8,1.8
Justin Schultz,PIT,D,29,2,13,15,0,47,1,5,6,25,41,89.8,3.096551724
Justin Williams,FA,RW,82,23,30,53,-4,237,9,5,14,55,32,279.3,3.406097561
Juuso Riikola,PIT,D,37,2,3,5,3,43,2,0,2,86,38,94.7,2.559459459
Juuso Valimaki,CGY,D,24,1,2,3,-2,28,0,0,0,21,43,49.2,2.05
Kailer Yamamoto,EDM,LW,17,1,1,2,-6,13,0,1,1,18,11,22.7,1.335294118
Kalle Kossila,TOR,C,8,1,0,1,-1,11,0,0,0,5,3,10.9,1.3625
Karl Alzner,MON,D,9,0,1,1,1,8,0,0,0,13,10,17.2,1.911111111
Karson Kuhlman,BOS,C,11,3,2,5,5,15,0,0,0,6,4,26.5,2.409090909
Kasperi Kapanen,TOR,RW,78,20,24,44,12,174,1,2,3,92,19,242.1,3.103846154
Keith Yandle,FLA,D,82,9,53,62,-17,199,7,32,39,47,76,304.6,3.714634146
Kenny Agostino,TOR,LW,63,6,18,24,-3,79,0,5,5,143,14,167.6,2.66031746
Kerby Rychel,FA,LW,2,0,0,0,-1,1,0,0,0,3,1,1.9,0.95
Kevan Miller,BOS,D,39,0,7,7,8,32,0,0,0,73,79,106.8,2.738461538
Kevin Connauton,COL,D,50,1,7,8,-2,75,0,0,0,108,75,137.5,2.75
Kevin Fiala,MIN,LW,83,13,26,39,-23,174,2,9,11,42,20,191.1,2.302409639
Kevin Gravel,TOR,D,36,0,3,3,-2,44,0,0,0,31,53,64.6,1.794444444
Kevin Hayes,PHI,C,71,19,36,55,-2,156,3,8,11,58,15,237.9,3.350704225
Kevin Labanc,SJ,RW,82,17,39,56,-1,130,2,18,20,66,16,241.5,2.945121951
Kevin Rooney,NJ,C,41,6,4,10,-4,39,0,0,0,77,22,89.1,2.173170732
Kevin Roy,PIT,C,3,0,0,0,-1,2,0,0,0,0,2,1.3,0.433333333
Kevin Shattenkirk,TB,D,73,2,26,28,-15,148,1,6,7,73,104,205.2,2.810958904
Kevin Stenlund,CLS,C,4,0,0,0,0,3,0,0,0,3,1,3.2,0.8
Kiefer Sherwood,ANH,LW,50,6,6,12,1,60,0,0,0,79,19,103.5,2.07
Kole Sherwood,CLS,C,2,0,0,0,0,2,0,0,0,10,1,6.3,3.15
Korbinian Holzer,ANH,D,22,1,3,4,5,15,0,0,0,61,38,67,3.045454545
Kris Letang,PIT,D,65,16,40,56,13,206,2,17,19,116,111,349.4,5.375384615
Kris Russell,EDM,D,72,3,13,16,5,63,0,0,0,93,185,201.7,2.801388889
Kristian Vesalainen,WPG,LW,5,0,1,1,0,1,0,0,0,1,1,3.4,0.68
Kurtis Gabriel,PHI,RW,22,2,2,4,0,7,0,0,0,78,8,55.8,2.536363636
Kurtis MacDermid,LA,D,11,0,1,1,-1,5,0,0,0,26,4,18.5,1.681818182
Kyle Brodziak,FA,C,70,6,3,9,-14,74,0,0,0,92,46,115.6,1.651428571
Kyle Capobianco,ARI,D,2,0,0,0,-2,1,0,0,0,2,2,1.4,0.7
Kyle Clifford,LA,LW,72,11,10,21,4,115,1,0,1,115,24,171.5,2.381944444
Kyle Connor,WPG,LW,82,34,32,66,-7,227,11,8,19,9,21,287.3,3.503658537
Kyle Okposo,BUF,RW,78,14,15,29,-9,147,7,4,11,87,27,194.3,2.491025641
Kyle Palmieri,NJ,RW,74,27,23,50,-9,224,11,7,18,98,35,296.6,4.008108108
Kyle Rau,MIN,C,6,0,1,1,0,6,0,0,0,11,2,10.9,1.816666667
Kyle Turris,NSH,C,55,7,16,23,-6,78,4,2,6,24,15,106.7,1.94
Lars Eller,WAS,C,81,13,23,36,-1,163,0,3,3,69,47,210.7,2.601234568
Laurent Dauphin,NSH,C,1,0,0,0,-1,2,0,0,0,0,1,0.8,0.8
Lawrence Pilut,BUF,D,33,1,5,6,-8,37,0,0,0,20,33,50.3,1.524242424
Lawson Crouse,ARI,LW,81,11,14,25,5,131,0,0,0,288,44,281.9,3.480246914
Lee Stempniak,FA,RW,2,0,0,0,-1,0,0,0,0,2,0,0.5,0.25
Leo Komarov,NYI,LW,82,6,20,26,18,78,0,0,0,203,38,218.7,2.667073171
Leon Draisaitl,EDM,C,82,50,55,105,2,231,16,13,29,57,26,423.9,5.169512195
Lias Andersson,NYR,LW,42,2,4,6,-13,41,0,0,0,60,8,57.9,1.378571429
Libor Hajek,NYR,D,5,1,0,1,1,10,0,0,0,5,3,11.5,2.3
Libor Sulak,FA,D,6,0,0,0,-4,7,0,0,0,18,5,12.3,2.05
Logan Brown,OTT,C,2,0,0,0,-2,2,0,0,0,0,1,0.3,0.15
Logan Couture,SJ,C,81,27,43,70,-6,204,6,12,18,65,52,322.1,3.97654321
Logan O'Connor,COL,C,5,0,0,0,-2,1,0,0,0,4,1,1.9,0.38
Loui Eriksson,VAN,RW,81,11,18,29,-11,107,1,2,3,3,28,124.8,1.540740741
Louis Belpedio,MIN,D,2,0,0,0,0,0,0,0,0,1,4,2.5,1.25
Luca Sbisa,WPG,D,9,0,1,1,0,5,0,0,0,17,7,16,1.777777778
Lucas Wallmark,CAR,C,81,10,18,28,-8,131,2,5,7,82,39,181.9,2.245679012
Lukas Radil,SJ,LW,36,7,4,11,7,40,0,0,0,29,9,67.5,1.875
Lukas Sedlak,FA,C,47,4,2,6,-5,43,0,0,0,69,20,75.2,1.6
Luke Glendening,DET,RW,78,10,13,23,2,102,0,0,0,198,102,247.8,3.176923077
Luke Johnson,MIN,C,15,0,1,1,-8,19,0,1,1,31,9,26.6,1.773333333
Luke Kunin,MIN,C,49,6,11,17,-9,88,0,1,1,67,34,122.2,2.493877551
Luke Schenn,TB,D,26,0,2,2,-10,30,0,0,0,105,39,83,3.192307692
Luke Witkowski,TB,RW,34,0,2,2,-5,14,0,0,0,67,27,54.1,1.591176471
Mackenzie MacEachern,STL,LW,29,3,2,5,0,33,0,0,0,49,4,52.7,1.817241379
MacKenzie Weegar,FLA,D,64,4,11,15,-3,79,0,1,1,127,103,180.1,2.8140625
Madison Bowey,DET,D,50,2,8,10,-1,48,0,0,0,72,63,108.2,2.164
Magnus Paajarvi,FA,LW,80,11,8,19,-14,119,0,0,0,65,67,155.6,1.945
Marc Methot,FA,D,9,0,0,0,-3,3,0,0,0,15,10,12.2,1.355555556
Marc Staal,NYR,D,79,3,10,13,-9,84,0,0,0,94,119,164.6,2.083544304
Marc-Edouard Vlasic,SJ,D,72,3,22,25,-6,100,0,1,1,23,114,159.5,2.215277778
Marco Scandella,MON,D,63,6,7,13,-13,83,0,0,0,53,75,122.7,1.947619048
Marcus Foligno,MIN,LW,82,7,12,19,-1,91,0,1,1,206,43,206.4,2.517073171
Marcus Johansson,BUF,LW,58,13,17,30,-16,115,2,7,9,28,24,146,2.517241379
Marcus Kruger,FA,C,74,4,8,12,-2,74,0,0,0,51,34,99.1,1.339189189
Marcus Pettersson,PIT,D,84,2,23,25,17,87,1,4,5,101,108,204.8,2.438095238
Marcus Sorensen,SJ,RW,80,17,13,30,10,100,0,0,0,88,29,180.5,2.25625
Mario Kempe,LA,LW,52,4,5,9,5,57,0,0,0,105,30,114.8,2.207692308
Mark Alt,COL,D,2,0,0,0,0,2,0,0,0,0,2,1.8,0.9
Mark Barberio,COL,D,12,1,0,1,-6,11,0,0,0,13,14,17.9,1.491666667
Mark Borowiecki,OTT,D,53,1,4,5,-12,59,0,0,0,212,93,181.1,3.416981132
Mark Friedman,PHI,D,1,0,0,0,-1,1,0,0,0,1,0,0.4,0.4
Mark Giordano,CGY,D,78,17,57,74,39,221,3,18,21,58,144,394.9,5.062820513
Mark Jankowski,CGY,C,79,14,18,32,6,99,0,0,0,30,56,163.6,2.070886076
Mark Letestu,WPG,C,2,0,0,0,-1,1,0,0,0,3,0,1.4,0.7
Mark Pysyk,FLA,D,70,1,10,11,-1,64,0,0,0,133,89,159.1,2.272857143
Mark Scheifele,WPG,C,82,38,46,84,8,199,12,11,23,54,54,366.6,4.470731707
Mark Stone,VGK,RW,77,33,40,73,17,199,6,14,20,72,71,358.6,4.657142857
Marko Dano,CLS,C,8,0,0,0,-1,3,0,0,0,16,3,10.2,1.275
Markus Granlund,EDM,C,77,12,10,22,-4,123,2,1,3,46,24,141.2,1.833766234
Markus Hannikainen,CLS,RW,44,4,3,7,-5,52,0,0,0,63,8,71.8,1.631818182
Markus Nutivaara,CLS,D,80,5,16,21,3,99,0,0,0,80,61,158.6,1.9825
Martin Frk,LA,RW,30,1,5,6,-9,28,1,0,1,35,4,40.2,1.34
Martin Hanzal,DAL,C,7,1,1,2,-4,14,1,0,1,14,4,18.6,2.657142857
Martin Marincin,TOR,D,24,1,4,5,-4,34,0,0,0,21,21,43.6,1.816666667
Martin Necas,CAR,C,7,1,1,2,0,6,0,0,0,3,2,9.9,1.414285714
Mason Appleton,WPG,C,36,3,7,10,9,29,0,0,0,28,12,59.1,1.641666667
Mathew Barzal,NYI,C,82,18,44,62,-5,179,3,15,18,25,56,269.6,3.287804878
Mathew Dumba,MIN,D,32,12,10,22,-5,93,6,6,12,60,43,154.2,4.81875
Mathieu Joseph,TB,RW,70,13,13,26,5,95,0,0,0,129,14,177,2.528571429
Mathieu Perreault,WPG,C,82,15,15,30,-1,95,4,3,7,127,25,195.5,2.384146341
Mats Zuccarello,MIN,RW,48,12,28,40,-8,104,3,12,15,57,43,194.6,4.054166667
Matt Bartkowski,MIN,D,2,1,0,1,2,2,0,0,0,1,1,5.8,2.9
Matt Beleskey,NYR,LW,4,1,0,1,1,3,0,0,0,7,1,8.7,2.175
Matt Benning,EDM,D,70,5,12,17,11,94,0,1,1,109,59,167.1,2.387142857
Matt Calvert,COL,LW,82,11,15,26,-10,141,1,1,2,115,51,199.4,2.431707317
Matt Cullen,FA,C,71,7,13,20,6,87,0,0,0,32,31,116.3,1.638028169
Matt Donovan,NSH,D,2,0,1,1,0,1,0,0,0,0,3,3.9,1.95
Matt Duchene,NSH,C,73,31,39,70,-3,172,6,8,14,28,40,286.3,3.921917808
Matt Grzelcyk,BOS,D,66,3,15,18,9,90,1,5,6,46,60,138.5,2.098484848
Matt Hendricks,FA,LW,26,0,3,3,-2,23,0,0,0,40,8,38.2,1.469230769
Matt Hunwick,BUF,D,14,0,2,2,-7,10,0,0,0,6,9,12,0.857142857
Matt Irwin,NSH,D,44,1,6,7,5,50,0,0,0,80,37,96,2.181818182
Matt Luff,LA,RW,33,8,3,11,-2,45,1,0,1,17,19,66,2
Matt Martin,NYI,LW,67,6,8,14,5,62,0,0,0,275,42,219.8,3.280597015
Matt Nieto,COL,LW,64,4,19,23,2,86,0,0,0,50,26,123.4,1.928125
Matt Niskanen,PHI,D,80,8,17,25,-3,143,1,1,2,167,137,267.7,3.34625
Matt Puempel,DET,LW,8,1,0,1,-2,10,1,0,1,4,5,11.5,1.4375
Matt Read,TOR,RW,12,1,0,1,-2,13,0,0,0,11,8,16.7,1.391666667
Matt Roy,LA,D,25,2,4,6,-1,34,0,0,0,38,47,69.6,2.784
Matt Tennyson,NJ,D,4,0,0,0,-4,4,0,0,0,10,2,5.6,1.4
Matthew Peca,MON,C,39,3,7,10,-14,35,0,0,0,33,21,57,1.461538462
Matthew Tkachuk,CGY,LW,80,34,43,77,14,207,11,13,24,104,13,360.3,4.50375
Mattias Ekholm,NSH,D,80,8,36,44,27,146,2,5,7,68,107,262.4,3.28
Mattias Janmark,DAL,C,81,6,19,25,-4,105,0,1,1,28,44,133,1.641975309
Max Domi,MON,C,82,28,44,72,20,203,4,7,11,53,39,320.2,3.904878049
Max Jones,ANH,LW,30,2,3,5,-1,58,0,1,1,30,5,53.2,1.773333333
Max Lajoie,OTT,D,56,7,8,15,-25,79,4,4,8,34,82,122.1,2.180357143
Max McCormick,CAR,LW,14,1,0,1,-6,12,0,0,0,21,6,18.3,1.307142857
Max Pacioretty,VGK,LW,66,22,18,40,-13,191,4,4,8,119,20,249.4,3.778787879
Max Veronneau,OTT,RW,12,2,2,4,-5,15,1,0,1,0,5,17,1.416666667
Maxim Mamin,FA,LW,7,0,0,0,-2,8,0,0,0,10,1,7.7,1.1
Maxime Comtois,ANH,LW,10,2,5,7,3,9,0,0,0,27,3,36.1,3.61
Melker Karlsson,SJ,C,79,12,4,16,-1,79,0,0,0,67,39,128.1,1.621518987
Michael Amadio,LA,C,43,6,7,13,-1,37,0,0,0,16,13,60.8,1.413953488
Michael Bunting,ARI,LW,5,1,0,1,0,5,0,0,0,6,1,8.5,1.7
Michael Chaput,ARI,C,32,0,5,5,-4,31,0,0,0,53,17,55.4,1.73125
Michael Dal Colle,NYI,LW,28,3,4,7,3,34,0,0,0,10,8,41.1,1.467857143
Michael Del Zotto,ANH,D,42,1,9,10,-2,45,0,0,0,129,53,129,3.071428571
Michael Frolik,BUF,LW,65,16,18,34,24,132,0,0,0,57,22,188.3,2.896923077
Michael Grabner,ARI,RW,41,9,7,16,-2,65,0,0,0,28,15,87.5,2.134146341
Michael McLeod,NJ,C,21,0,3,3,-8,21,0,0,0,41,4,32.9,1.566666667
Michael Raffl,PHI,LW,67,6,12,18,-1,65,0,0,0,96,29,130,1.940298507
Michael Rasmussen,DET,C,62,8,10,18,-8,74,4,0,4,84,28,129.6,2.090322581
Michael Stone,CGY,D,14,0,5,5,0,12,0,0,0,27,16,36.3,2.592857143
Michal Kempny,WAS,D,71,6,19,25,24,111,0,0,0,84,135,221.9,3.125352113
Micheal Ferland,VAN,LW,71,17,23,40,13,156,6,7,13,182,19,279.4,3.935211268
Micheal Haley,NYR,LW,43,2,4,6,-2,34,0,0,0,76,16,72.6,1.688372093
Miikka Salomaki,NSH,RW,37,3,4,7,5,51,0,0,0,72,20,85.9,2.321621622
Mika Zibanejad,NYR,C,82,30,44,74,-12,236,11,12,23,134,66,389.4,4.748780488
Mikael Backlund,CGY,C,77,21,26,47,34,205,1,1,2,52,26,255,3.311688312
Mikael Granlund,NSH,C,79,16,38,54,-8,189,2,18,20,46,40,258.6,3.273417722
Mike Green,DET,D,43,5,21,26,-1,92,0,3,3,60,56,154.3,3.588372093
Mike Hoffman,FLA,LW,82,36,34,70,-24,253,17,18,35,42,26,334.2,4.075609756
Mike Matheson,FLA,D,75,8,19,27,-24,129,0,6,6,63,132,205.1,2.734666667
Mike Reilly,OTT,D,57,3,8,11,0,101,1,0,1,48,53,116.9,2.050877193
Mikhail Sergachev,TB,D,75,6,26,32,12,128,0,6,6,97,93,228.2,3.042666667
Mikhail Vorobyov,PHI,C,15,1,1,2,0,10,0,0,0,4,4,13,0.866666667
Mikkel Boedker,OTT,LW,71,7,28,35,-23,88,2,5,7,54,28,148.7,2.094366197
Mikko Koivu,MIN,C,48,8,21,29,-2,89,2,10,12,13,32,135.1,2.814583333
Mikko Rantanen,COL,RW,74,31,56,87,13,193,16,17,33,59,41,371.7,5.022972973
Milan Lucic,CGY,LW,79,6,14,20,-9,74,2,2,4,259,22,215.6,2.729113924
Miles Wood,NJ,LW,63,10,14,24,-10,159,1,2,3,97,27,181.6,2.882539683
Mirco Mueller,NJ,D,53,1,10,11,-3,39,0,0,0,75,61,105.1,1.983018868
Miro Heiskanen,DAL,D,82,12,21,33,-14,182,2,6,8,34,71,204.3,2.491463415
Mitch Marner,TOR,C,82,26,68,94,22,233,3,18,21,29,43,375.2,4.575609756
Morgan Rielly,TOR,D,82,20,52,72,24,223,3,18,21,61,114,373.7,4.557317073
Nate Prosser,PHI,D,15,0,0,0,1,10,0,0,0,17,13,19.5,1.3
Nate Schmidt,VGK,D,61,9,21,30,22,112,1,7,8,37,100,201.3,3.3
Nate Thompson,MON,C,78,5,8,13,-1,71,0,0,0,87,44,124.4,1.594871795
Nathan Bastian,NJ,RW,7,3,0,3,0,13,0,0,0,24,1,26.7,3.814285714
Nathan Beaulieu,WPG,D,48,3,9,12,6,60,0,1,1,60,42,106,2.208333333
Nathan MacKinnon,COL,C,82,41,58,99,20,365,12,25,37,54,31,474.5,5.786585366
Nathan Walker,STL,C,3,0,1,1,1,2,0,0,0,5,0,5.8,1.933333333
Nazem Kadri,COL,C,73,16,28,44,-2,184,4,9,13,85,13,238.6,3.268493151
Neal Pionk,WPG,D,73,6,20,26,-16,132,2,11,13,138,98,233.8,3.202739726
Nelson Nogier,WPG,D,1,0,0,0,0,1,0,0,0,0,1,0.9,0.9
Nic Dowd,WAS,C,64,8,14,22,10,47,0,0,0,97,37,142.8,2.23125
Nick Bjugstad,PIT,C,64,14,12,26,6,154,2,4,6,126,27,213.1,3.3296875
Nick Bonino,NSH,C,81,17,18,35,27,118,3,0,3,24,70,197.7,2.440740741
Nick Cousins,MON,C,81,7,20,27,-8,144,1,2,3,115,51,200.6,2.47654321
Nick Foligno,CLS,LW,73,17,18,35,12,141,2,2,4,175,51,266.4,3.649315068
Nick Holden,VGK,D,61,3,12,15,5,77,0,0,0,104,76,156.3,2.562295082
Nick Jensen,WAS,D,80,2,18,20,4,94,0,0,0,82,105,175.1,2.18875
Nick Lappin,STL,RW,11,0,0,0,-6,11,0,0,0,16,3,10.9,0.990909091
Nick Leddy,NYI,D,82,4,22,26,0,116,0,10,10,77,89,195.4,2.382926829
Nick Paul,OTT,LW,20,1,1,2,-10,30,0,0,0,28,4,28,1.4
Nick Ritchie,ANH,LW,60,9,22,31,6,96,2,7,9,123,31,198.4,3.306666667
Nick Schmaltz,ARI,RW,40,7,18,25,-12,62,5,3,8,5,12,92.3,2.3075
Nick Seeler,MIN,D,71,2,5,7,-4,67,0,0,0,78,116,137.8,1.94084507
Nicklas Backstrom,WAS,C,80,22,52,74,2,169,7,18,25,54,30,305.6,3.82
Nico Hischier,NJ,C,69,17,30,47,0,160,3,8,11,53,44,234.5,3.398550725
Nico Sturm,MIN,C,2,0,0,0,0,7,0,0,0,3,2,5.3,2.65
Nicolas Aube-Kubel,PHI,C,9,0,0,0,1,2,0,0,0,14,0,8.3,0.922222222
Nicolas Deslauriers,ANH,LW,48,2,3,5,-12,48,0,0,0,135,22,103.7,2.160416667
Nicolas Petan,TOR,C,18,1,2,3,-5,15,0,0,0,2,4,13.5,0.75
Nicolas Roy,VGK,C,6,0,0,0,0,1,0,0,0,7,1,4.4,0.733333333
Nikita Kucherov,TB,RW,82,41,87,128,24,246,15,33,48,44,31,492.9,6.01097561
Nikita Scherbak,FA,RW,8,1,0,1,-4,12,0,0,0,9,1,10.8,1.35
Nikita Soshnikov,FA,LW,5,0,0,0,-1,1,0,0,0,5,2,3.4,0.68
Nikita Zadorov,COL,D,70,7,7,14,19,100,0,0,0,228,67,232,3.314285714
Nikita Zaitsev,OTT,D,81,3,11,14,2,71,0,0,0,139,151,205.4,2.535802469
Niklas Hjalmarsson,ARI,D,82,0,10,10,8,57,0,0,0,45,187,162.8,1.985365854
Niklas Kronwall,FA,D,79,3,24,27,-5,71,1,7,8,84,96,180.9,2.289873418
Nikolaj Ehlers,WPG,LW,62,21,16,37,2,158,2,5,7,27,16,187.7,3.027419355
Nikolay Goldobin,VAN,RW,63,7,20,27,-10,105,1,8,9,15,21,125,1.984126984
Nino Niederreiter,CAR,RW,82,23,30,53,-4,184,6,9,15,94,20,272.6,3.324390244
Noah Hanifin,CGY,D,80,5,28,33,18,116,1,4,5,87,83,216.4,2.705
Noah Juulsen,MON,D,21,1,4,5,5,22,0,0,0,60,39,71.8,3.419047619
Noel Acciari,FLA,C,72,6,8,14,-3,99,0,0,0,221,36,200.6,2.786111111
Nolan Patrick,PHI,C,72,13,18,31,-8,115,1,1,2,72,26,168,2.333333333
Oliver Bjorkstrand,CLS,RW,77,23,13,36,8,161,3,0,3,43,34,204.9,2.661038961
Oliver Ekman-Larsson,ARI,D,81,14,30,44,-16,176,5,14,19,162,52,290.4,3.585185185
Oliver Kylington,CGY,D,38,3,5,8,3,21,0,0,0,11,41,54.9,1.444736842
Olli Maatta,CHI,D,60,1,13,14,9,74,1,3,4,97,116,173.6,2.893333333
Ondrej Kase,ANH,RW,30,11,9,20,0,94,1,3,4,17,11,106.6,3.553333333
Ondrej Palat,TB,LW,64,8,26,34,4,100,2,6,8,104,34,195,3.046875
Oscar Fantenberg,VAN,D,61,2,2,4,3,70,0,0,0,91,74,122,2
Oscar Klefbom,EDM,D,61,5,23,28,-11,167,1,10,11,44,102,206.3,3.381967213
Oscar Lindberg,FA,C,55,9,11,20,4,91,0,1,1,104,27,153.9,2.798181818
Oskar Lindblom,PHI,LW,81,17,16,33,-9,162,2,1,3,68,52,206.3,2.54691358
Oskar Sundqvist,STL,C,74,14,17,31,-1,113,0,1,1,101,31,187.7,2.536486486
P.K. Subban,NJ,D,63,9,22,31,5,168,2,8,10,56,75,216.2,3.431746032
Par Lindholm,BOS,C,65,1,12,13,5,65,0,0,0,58,55,112,1.723076923
Patric Hornqvist,PIT,RW,69,18,19,37,-3,197,6,6,12,150,34,273.3,3.960869565
Patrice Bergeron,BOS,C,65,32,47,79,23,205,9,18,27,43,60,362,5.569230769
Patrick Eaves,ANH,RW,7,0,0,0,-4,6,0,0,0,14,1,7.9,1.128571429
Patrick Kane,CHI,RW,81,44,66,110,2,341,9,21,30,21,18,450.9,5.566666667
Patrick Marleau,SJ,LW,82,16,21,37,-6,161,4,6,10,74,41,218.9,2.669512195
Patrick Maroon,TB,LW,74,10,18,28,-3,118,2,9,11,135,7,193.7,2.617567568
Patrick Russell,EDM,RW,6,0,0,0,0,6,0,0,0,9,2,7.9,1.316666667
Patrik Berglund,FA,C,23,2,2,4,-5,25,0,0,0,25,16,38,1.652173913
Patrik Laine,WPG,RW,82,30,20,50,-24,245,15,8,23,70,44,296,3.609756098
Patrik Nemeth,DET,D,74,1,9,10,5,57,0,0,0,137,131,180.3,2.436486486
Paul Byron,MON,C,56,15,16,31,16,94,0,1,1,114,36,198.6,3.546428571
Paul Carey,BOS,RW,7,0,0,0,0,4,0,0,0,3,3,4.6,0.657142857
Paul LaDue,LA,D,33,2,3,5,0,33,0,0,0,51,25,63.2,1.915151515
Paul Stastny,VGK,C,50,13,29,42,14,103,1,3,4,35,15,174.2,3.484
Pavel Buchnevich,NYR,LW,64,21,17,38,-10,119,7,5,12,60,20,191.6,2.99375
Pavel Zacha,NJ,C,61,13,12,25,-6,99,4,2,6,68,24,151.6,2.485245902
Peter Cehlarik,BOS,C,20,4,2,6,3,30,1,0,1,5,7,36.5,1.825
Phil Di Giuseppe,NYR,LW,24,1,3,4,-3,31,0,0,0,54,9,51.4,2.141666667
Phil Kessel,ARI,RW,82,27,55,82,-19,215,12,24,36,12,18,318.5,3.884146341
Philip Varone,MON,C,47,3,4,7,-2,34,0,0,0,23,19,50.6,1.076595745
Philippe Myers,PHI,D,21,1,1,2,-5,25,0,0,0,42,8,37.5,1.785714286
Phillip Danault,MON,C,81,12,41,53,17,132,0,4,4,95,60,260.8,3.219753086
Pierre-Edouard Bellemare,COL,C,76,6,9,15,2,108,0,0,0,71,51,141.2,1.857894737
Pierre-Luc Dubois,CLS,C,82,27,34,61,16,174,2,7,9,115,52,319.1,3.891463415
Pontus Aberg,TOR,LW,59,12,13,25,-14,101,3,4,7,45,11,130.4,2.210169492
Quinn Hughes,VAN,D,5,0,3,3,0,6,0,2,2,1,1,11.4,2.28
Radek Faksa,DAL,C,81,15,15,30,-3,114,1,2,3,103,65,206.1,2.544444444
Radim Simek,SJ,D,41,1,8,9,7,41,0,0,0,67,34,89.4,2.180487805
Radko Gudas,WAS,D,77,4,16,20,6,136,0,0,0,255,133,295.4,3.836363636
Rasmus Andersson,CGY,D,79,2,17,19,17,115,0,2,2,52,83,164,2.075949367
Rasmus Dahlin,BUF,D,82,9,35,44,-13,177,5,15,20,97,66,262.8,3.204878049
Rasmus Ristolainen,BUF,D,78,5,38,43,-41,182,1,16,17,235,121,338.3,4.337179487
Reid Boucher,VAN,RW,1,0,0,0,0,0,0,0,0,1,0,0.5,0.5
Reilly Smith,VGK,RW,74,19,34,53,13,178,4,10,14,39,33,252.7,3.414864865
Rem Pitlick,NSH,C,1,0,0,0,0,0,0,0,0,0,0,0,0
Remi Elie,BUF,LW,16,0,1,1,-3,9,0,0,0,30,3,20.6,1.2875
Richard Panik,WAS,RW,75,14,19,33,-3,140,0,2,2,137,52,231,3.08
Rickard Rakell,ANH,C,69,18,25,43,-13,194,6,7,13,82,38,248.1,3.595652174
Riley Nash,CLS,C,78,3,9,12,-8,79,0,0,0,72,43,112.1,1.437179487
Riley Sheahan,EDM,C,82,9,10,19,-9,110,0,0,0,72,44,144.5,1.762195122
Riley Stillman,FLA,D,1,0,0,0,0,1,0,0,0,5,0,2.9,2.9
Robby Fabbri,DET,LW,32,2,4,6,-4,43,0,0,0,30,8,48.2,1.50625
Robert Bortuzzo,STL,D,59,2,8,10,9,75,0,0,0,95,72,140,2.372881356
Robert Hagg,PHI,D,82,5,15,20,-3,86,0,0,0,258,158,285.9,3.486585366
Robert Thomas,STL,C,70,9,24,33,-2,80,3,4,7,13,22,130.5,1.864285714
Rocco Grimaldi,NSH,C,53,5,8,13,-2,81,0,0,0,32,20,88.4,1.667924528
Roman Josi,NSH,D,82,15,41,56,9,274,2,10,12,53,144,351.6,4.287804878
Roman Polak,DAL,D,77,1,8,9,6,77,0,0,0,191,152,224.3,2.912987013
Ron Hainsey,OTT,D,81,5,18,23,30,81,0,0,0,91,144,215.9,2.665432099
Roope Hintz,DAL,LW,58,9,13,22,-11,99,3,3,6,87,36,154.6,2.665517241
Ross Johnston,NYI,LW,17,1,3,4,3,12,0,0,0,43,1,37.3,2.194117647
Rourke Chartier,FA,C,13,1,0,1,-5,19,0,0,0,14,3,16.6,1.276923077
Rudolfs Balcers,OTT,LW,36,5,9,14,-7,48,3,1,4,18,24,73.7,2.047222222
Ryan Callahan,OTT,RW,52,7,10,17,7,76,1,0,1,89,25,132.9,2.555769231
Ryan Carpenter,CHI,C,68,5,13,18,-6,102,0,0,0,126,17,150.3,2.210294118
Ryan Donato,MIN,C,56,10,15,25,-15,139,3,5,8,24,21,138.6,2.475
Ryan Dzingel,CAR,C,78,26,30,56,-9,159,5,6,11,54,38,254.1,3.257692308
Ryan Ellis,NSH,D,82,7,34,41,21,149,1,4,5,71,154,276.6,3.373170732
Ryan Getzlaf,ANH,C,67,14,34,48,-19,133,1,10,11,150,74,276.7,4.129850746
Ryan Graves,COL,D,26,3,2,5,4,26,0,0,0,32,51,66.9,2.573076923
Ryan Hartman,MIN,RW,83,12,14,26,1,145,0,0,0,107,39,195.5,2.355421687
Ryan Johansen,NSH,C,80,14,50,64,7,136,0,16,16,95,23,274.9,3.43625
Ryan Kesler,ANH,C,60,5,3,8,-19,86,1,2,3,93,56,123.4,2.056666667
Ryan Kuffner,DET,LW,10,0,0,0,-4,8,0,0,0,4,5,5.7,0.57
Ryan Lindgren,NYR,D,5,0,0,0,-6,8,0,0,0,11,9,10.2,2.04
Ryan Lomberg,CGY,LW,4,0,0,0,0,1,0,0,0,12,0,6.4,1.6
Ryan McDonagh,TB,D,82,9,37,46,38,128,0,3,3,98,161,303.7,3.703658537
Ryan Murphy,FA,D,3,0,1,1,1,1,0,1,1,1,3,5.9,1.966666667
Ryan Murray,CLS,D,56,1,28,29,20,71,0,1,1,27,93,158.4,2.828571429
Ryan Nugent-Hopkins,EDM,LW,82,28,41,69,-13,208,8,18,26,69,40,323.2,3.941463415
Ryan O'Reilly,STL,C,82,28,49,77,22,234,6,16,22,31,36,342.1,4.17195122
Ryan Poehling,MON,C,1,3,0,3,3,3,0,0,0,1,0,12.2,12.2
Ryan Pulock,NYI,D,82,9,28,37,21,180,3,6,9,143,148,320,3.902439024
Ryan Reaves,VGK,RW,80,9,11,20,1,95,3,0,3,305,24,255,3.1875
Ryan Spooner,FA,C,52,3,6,9,-12,67,0,1,1,39,7,65.8,1.265384615
Ryan Strome,NYR,C,81,19,16,35,-3,110,4,3,7,76,36,194.5,2.401234568
Ryan Suter,MIN,D,82,7,40,47,-8,136,3,12,15,78,109,259.9,3.169512195
Saku Maenalanen,FA,LW,34,4,4,8,0,36,0,0,0,45,10,61.9,1.820588235
Sam Bennett,CGY,LW,71,13,14,27,-6,115,4,2,6,121,27,190,2.676056338
Sam Carrick,ANH,C,6,0,1,1,-1,5,0,0,0,15,2,12,2
Sam Gagner,EDM,C,32,6,7,13,-6,68,1,0,1,21,7,71.2,2.225
Sam Reinhart,BUF,C,82,22,43,65,-10,180,2,13,15,38,47,276.5,3.37195122
Sam Steel,ANH,C,22,6,5,11,2,33,0,2,2,9,6,51.7,2.35
Sami Niku,WPG,D,30,1,3,4,0,19,0,0,0,10,30,36.6,1.22
Sami Vatanen,NJ,D,50,4,13,17,-17,107,3,2,5,68,77,149.8,2.996
Sammy Blais,STL,LW,32,2,2,4,-1,27,0,0,0,93,12,72.8,2.275
Samuel Girard,COL,D,82,4,23,27,8,116,0,9,9,65,90,194.9,2.376829268
Samuel Morin,PHI,D,5,0,0,0,-3,5,0,0,0,9,7,8.5,1.7
Scott Harrington,CLS,D,73,2,15,17,6,54,0,0,0,73,81,137.6,1.884931507
Scott Laughton,PHI,C,82,12,20,32,-11,130,0,0,0,146,46,218.5,2.664634146
Scott Mayfield,NYI,D,79,4,15,19,18,104,0,0,0,118,159,231.1,2.925316456
Scott Wilson,BUF,LW,15,0,3,3,-8,25,0,0,0,29,2,27.5,1.833333333
Sean Couturier,PHI,C,80,33,43,76,2,223,8,9,17,40,60,342.2,4.2775
Sean Kuraly,BOS,C,71,8,13,21,6,134,0,0,0,129,35,188.6,2.656338028
Sean Monahan,CGY,C,78,34,48,82,7,211,12,11,23,36,24,338.9,4.344871795
Sean Walker,LA,D,39,3,7,10,-8,55,1,0,1,43,40,83.5,2.141025641
Sebastian Aho,CAR,LW,82,30,53,83,25,243,3,21,24,65,34,379.2,4.624390244
Seth Jones,CLS,D,75,9,37,46,1,184,0,10,10,106,133,304.6,4.061333333
Shayne Gostisbehere,PHI,D,78,9,28,37,-20,180,4,10,14,46,102,233,2.987179487
Shea Theodore,VGK,D,79,12,25,37,-4,202,4,5,9,27,91,232.8,2.946835443
Shea Weber,MON,D,58,14,19,33,15,166,5,1,6,129,110,279.4,4.817241379
Sheldon Dries,COL,C,40,3,3,6,-7,44,0,0,0,66,20,72.1,1.8025
Sheldon Rempal,LA,LW,7,0,0,0,-1,3,0,0,0,0,1,1.2,0.171428571
Sidney Crosby,PIT,C,79,35,65,100,18,220,12,17,29,85,43,425,5.379746835
Slater Koekkoek,CHI,D,31,2,4,6,4,36,0,0,0,54,48,81.4,2.625806452
Sonny Milano,CLS,LW,8,1,0,1,0,5,0,0,0,5,0,7.5,0.9375
Stefan Elliott,FA,D,3,0,1,1,1,3,0,0,0,2,1,5.2,1.733333333
Stefan Noesen,SJ,C,41,3,5,8,-19,64,0,0,0,95,21,93.1,2.270731707
Stephen Gionta,FA,C,5,0,0,0,-4,4,0,0,0,14,2,7.6,1.52
Steve Kampfer,BOS,D,35,3,3,6,-6,40,1,1,2,44,32,68,1.942857143
Steve Santini,NSH,D,39,1,3,4,-6,41,0,0,0,80,43,83.9,2.151282051
Steven Fogarty,NYR,C,10,0,0,0,-1,9,0,0,0,6,3,7.6,0.76
Steven Stamkos,TB,C,82,45,53,98,4,234,19,21,40,72,40,432.6,5.275609756
Sven Andrighetto,FA,RW,64,7,10,17,10,95,0,0,0,29,32,114.5,1.7890625
Sven Baertschi,VAN,LW,26,9,5,14,-9,43,3,4,7,18,13,72.2,2.776923077
T.J. Brodie,CGY,D,79,9,25,34,29,102,1,3,4,21,86,189.8,2.402531646
T.J. Oshie,WAS,RW,69,25,29,54,5,143,6,8,14,133,55,300.7,4.357971014
Tage Thompson,BUF,RW,65,7,5,12,-22,108,1,0,1,66,9,101.7,1.564615385
Tanner Fritz,NYI,LW,8,0,1,1,-3,6,0,0,0,18,6,14.9,1.8625
Tanner Pearson,VAN,LW,80,18,9,27,-15,147,3,2,5,128,41,212.8,2.66
Taro Hirose,DET,LW,10,1,6,7,0,15,0,1,1,1,9,27,2.7
Taylor Fedun,DAL,D,54,4,7,11,2,86,0,2,2,19,58,101.9,1.887037037
Taylor Hall,ARI,LW,33,11,26,37,-6,113,1,11,12,22,29,164.7,4.990909091
Teddy Blueger,PIT,C,28,6,4,10,7,33,0,0,0,52,14,75.7,2.703571429
Teuvo Teravainen,CAR,C,82,21,55,76,30,167,8,16,24,35,23,307.8,3.753658537
Thomas Chabot,OTT,D,70,14,41,55,-12,185,1,15,16,71,112,299.5,4.278571429
Thomas Hickey,NYI,D,40,0,4,4,5,47,0,0,0,40,71,84.8,2.12
Thomas Vanek,FA,LW,64,16,20,36,-12,108,4,7,11,38,13,161.7,2.5265625
Tim Gettinger,NYR,LW,4,0,0,0,0,2,0,0,0,15,3,9.8,2.45
Tim Heed,SJ,D,37,2,11,13,9,41,1,2,3,16,31,75.4,2.037837838
Tim Schaller,VAN,C,47,3,7,10,-2,44,0,0,0,66,18,81.6,1.736170213
Timo Meier,SJ,LW,78,30,36,66,9,250,6,4,10,99,40,346,4.435897436
Tobias Rieder,CGY,RW,67,0,11,11,-8,92,0,2,2,69,44,113.3,1.691044776
Tom Kuhnhackl,NYI,RW,36,4,5,9,1,30,0,0,0,48,41,79,2.194444444
Tom Pyatt,FA,C,37,0,2,2,-16,29,0,0,0,15,46,38.1,1.02972973
Tom Wilson,WAS,RW,63,22,18,40,11,130,3,2,5,200,52,290.5,4.611111111
Tomas Hertl,SJ,LW,77,35,39,74,5,176,11,4,15,53,64,329.4,4.277922078
Tomas Hyka,FA,RW,17,1,3,4,-2,22,0,2,2,6,5,24.3,1.429411765
Tomas Nosek,VGK,LW,68,8,9,17,-10,116,0,0,0,75,23,132.4,1.947058824
Tomas Plekanec,FA,C,3,1,0,1,0,8,0,0,0,1,1,7.2,2.4
Tomas Tatar,MON,LW,80,25,33,58,21,195,4,4,8,77,30,291,3.6375
Torey Krug,BOS,D,64,6,47,53,-2,151,2,28,30,53,60,257.9,4.0296875
Travis Boyd,WAS,C,53,5,15,20,6,35,0,2,2,13,21,81,1.528301887
Travis Dermott,TOR,D,64,4,13,17,-5,98,0,0,0,100,57,153.2,2.39375
Travis Hamonic,CGY,D,69,7,12,19,21,128,0,0,0,44,167,212.2,3.075362319
Travis Konecny,PHI,C,82,24,25,49,-4,182,4,4,8,65,45,255.8,3.119512195
Travis Sanheim,PHI,D,82,9,26,35,-4,121,2,3,5,45,133,219.4,2.675609756
Travis Zajac,NJ,C,80,19,27,46,-25,120,5,7,12,66,38,210.5,2.63125
Trent Frederic,BOS,C,15,0,0,0,-4,19,0,0,0,18,3,16.1,1.073333333
Trevor Carrick,SJ,D,1,0,0,0,-1,0,0,0,0,1,1,0.5,0.5
Trevor Daley,DET,D,44,2,6,8,-3,47,0,0,0,14,53,68.8,1.563636364
Trevor Lewis,LA,C,44,3,9,12,-9,87,0,0,0,53,25,96.3,2.188636364
Trevor Moore,TOR,LW,25,2,6,8,1,26,0,0,0,15,7,39.9,1.596
Trevor van Riemsdyk,CAR,D,78,3,11,14,-4,102,0,0,0,42,84,132.8,1.702564103
Troy Brouwer,STL,RW,75,12,9,21,-6,86,0,0,0,177,38,192.9,2.572
Troy Stecher,VAN,D,78,2,21,23,9,105,0,2,2,91,96,190,2.435897436
Troy Terry,ANH,C,32,4,9,13,8,25,2,4,6,4,12,58,1.8125
Ty Rattie,FA,RW,50,4,7,11,-2,84,0,1,1,57,7,91.6,1.832
Tyler Bertuzzi,DET,LW,73,21,26,47,11,131,3,3,6,76,39,236.4,3.238356164
Tyler Bozak,STL,C,72,13,25,38,-3,141,2,6,8,52,33,194.4,2.7
Tyler Ennis,OTT,LW,51,12,6,18,-6,81,2,3,5,49,14,113.9,2.233333333
Tyler Johnson,TB,C,80,29,18,47,15,163,1,7,8,50,32,244.7,3.05875
Tyler Lewington,WAS,D,2,1,1,2,3,3,0,0,0,4,1,10.2,5.1
Tyler Motte,VAN,C,74,9,7,16,-12,114,0,0,0,200,52,206.6,2.791891892
Tyler Myers,VAN,D,80,9,22,31,11,156,0,7,7,97,99,243.9,3.04875
Tyler Pitlick,PHI,C,47,8,4,12,-2,75,1,0,1,93,27,122,2.595744681
Tyler Seguin,DAL,C,82,33,47,80,17,334,9,18,27,74,47,422.6,5.153658537
Tyler Toffoli,LA,RW,82,13,21,34,-16,226,3,2,5,39,23,199.4,2.431707317
Tyrell Goulbourne,VGK,LW,2,0,0,0,0,3,0,0,0,6,0,4.2,2.1
Tyson Barrie,TOR,D,78,14,45,59,-3,218,2,23,25,48,93,313.2,4.015384615
Tyson Jost,COL,C,70,11,15,26,-2,114,4,1,5,48,35,154.1,2.201428571
Urho Vaakanainen,BOS,D,2,0,0,0,-1,2,0,0,0,0,0,0.3,0.15
Valentin Zykov,VGK,RW,28,2,3,5,-5,29,0,2,2,26,6,39.1,1.396428571
Valeri Nichushkin,COL,LW,57,0,10,10,-4,65,0,0,0,71,32,95.5,1.675438596
Valtteri Filppula,DET,C,72,17,14,31,19,78,0,0,0,12,34,142.7,1.981944444
Victor Hedman,TB,D,70,12,42,54,24,182,2,23,25,59,97,307.8,4.397142857
Victor Mete,MON,D,71,0,13,13,17,65,0,0,0,21,95,118.5,1.669014085
Victor Olofsson,BUF,LW,6,2,2,4,1,21,2,0,2,2,3,23.4,3.9
Victor Rask,MIN,C,49,3,6,9,-4,55,0,2,2,40,12,69,1.408163265
Viktor Arvidsson,NSH,LW,58,34,14,48,12,195,3,1,4,18,23,238.5,4.112068966
Vince Dunn,STL,D,78,12,23,35,14,150,3,5,8,48,68,215,2.756410256
Vincent Trocheck,FLA,C,55,10,24,34,-9,158,3,10,13,112,42,226.7,4.121818182
Vinni Lettieri,NYR,C,27,1,2,3,-7,40,1,1,2,41,11,47.5,1.759259259
Vinnie Hinostroza,ARI,C,72,16,23,39,-4,152,3,2,5,69,41,212.8,2.955555556
Vitali Abramov,OTT,RW,1,0,0,0,-3,0,0,0,0,0,1,-1,-1
Vladimir Sobotka,BUF,C,69,5,8,13,-20,71,0,0,0,87,30,107.9,1.563768116
Vladimir Tarasenko,STL,RW,76,33,35,68,8,275,12,10,22,88,40,369,4.855263158
Vladislav Kamenev,COL,C,23,2,3,5,-2,22,1,0,1,20,4,32.8,1.426086957
Vladislav Namestnikov,OTT,C,78,11,20,31,-7,119,1,2,3,140,62,221.1,2.834615385
Wade Megan,FA,C,11,0,1,1,-4,16,0,0,0,4,4,10.4,0.945454545
Warren Foegele,CAR,LW,77,10,5,15,-17,106,0,0,0,126,19,146.4,1.901298701
Wayne Simmonds,NJ,RW,79,17,13,30,-16,157,5,3,8,137,28,222.3,2.813924051
Will Borgen,BUF,D,4,0,0,0,-5,2,0,0,0,12,3,5.8,1.45
Will Butcher,NJ,D,78,4,26,30,-17,108,1,13,14,38,74,168.7,2.162820513
William Carrier,VGK,LW,54,8,1,9,-4,85,0,0,0,277,13,203,3.759259259
William Karlsson,VGK,C,82,24,32,56,1,169,7,7,14,51,55,271.1,3.306097561
William Nylander,TOR,C,54,7,20,27,-4,130,1,5,6,16,14,132,2.444444444
Xavier Ouellet,MON,D,19,0,3,3,-3,32,0,0,0,32,30,48.3,2.542105263
Yanni Gourde,TB,LW,80,22,26,48,9,130,5,4,9,83,30,240,3
Yannick Weber,NSH,D,62,2,6,8,7,67,0,0,0,64,32,96.3,1.553225806
Zac Dalpe,CLS,C,1,0,1,1,1,1,0,0,0,0,0,2.9,2.9
Zac Rinaldo,CGY,C,23,1,2,3,1,11,0,0,0,47,8,39.4,1.713043478
Zach Aston-Reese,PIT,C,43,8,9,17,12,76,0,0,0,138,37,165.9,3.858139535
Zach Bogosian,BUF,D,65,3,16,19,-5,93,0,1,1,83,116,176.2,2.710769231
Zach Hyman,TOR,RW,71,21,20,41,16,144,0,0,0,102,39,239.1,3.367605634
Zach Parise,MIN,LW,74,28,33,61,-2,229,10,6,16,49,71,316.6,4.278378378
Zach Sanford,STL,LW,60,8,12,20,8,77,0,1,1,48,37,126.3,2.105
Zach Trotman,PIT,D,13,0,1,1,4,16,0,1,1,20,18,30.4,2.338461538
Zach Werenski,CLS,D,82,11,33,44,-12,168,2,13,15,67,89,253.2,3.087804878
Zachary Senyshyn,BOS,RW,2,1,0,1,0,4,0,0,0,1,0,5.1,2.55
Zack Kassian,EDM,RW,79,15,11,26,-6,111,0,0,0,191,15,211.4,2.675949367
Zack MacEwen,VAN,C,4,0,1,1,-4,2,0,0,0,4,1,3.3,0.825
Zack Smith,CHI,C,70,9,19,28,-6,101,0,0,0,136,27,183.9,2.627142857
Zdeno Chara,BOS,D,62,5,9,14,22,99,1,2,3,81,88,171.1,2.759677419
Zemgus Girgensons,BUF,C,72,5,13,18,-11,78,0,0,0,144,29,153.2,2.127777778